Dato,Destino,Fuente,Reset,Valido,Overflow,Completado,Escritura,Lectura,Latencia
252afd5a9, 52, 10, 0, 1, 0, 1, 215, 95, 120
23841ad, 2, 12, 0, 1, 0, 1, 235, 75, 160
330392ecd, 30, 9, 0, 1, 0, 1, 235, 95, 140
2519b8f56, 51, 7, 0, 1, 0, 1, 275, 255, 20
1156f8d98, 15, 1, 0, 1, 0, 1, 295, 175, 120
13596a1c8, 35, 12, 0, 1, 0, 1, 295, 195, 100
1d4cac9, 1, 5, 0, 1, 0, 1, 355, 275, 80
2ffb472ee, ff, 9, 0, 1, 0, 1, 355, 235, 120
44784b4, 4, 14, 0, 1, 0, 1, 375, 195, 180
135b5a4a5, 35, 2, 0, 1, 0, 1, 375, 115, 260
115e2d79a, 15, 4, 0, 1, 0, 1, 415, 115, 300
310635980, 10, 5, 0, 1, 0, 1, 475, 415, 60
2ff84f413, ff, 6, 0, 1, 0, 1, 495, 115, 380
320261d13, 20, 7, 0, 1, 0, 1, 515, 355, 160
125c40b03, 25, 10, 0, 1, 0, 1, 535, 175, 360
135b46aea, 35, 6, 0, 1, 0, 1, 535, 255, 280
320731a6e, 20, 3, 0, 1, 0, 1, 555, 155, 400
1153b9388, 15, 1, 0, 1, 0, 1, 575, 315, 260
310a55bce, 10, 15, 0, 1, 0, 1, 595, 75, 520
330c97200, 30, 2, 0, 1, 0, 1, 615, 235, 380
2ffef19f0, ff, 10, 0, 1, 0, 1, 655, 515, 140
22a25f1, 2, 6, 0, 1, 0, 1, 675, 355, 320
340e16dc2, 40, 13, 0, 1, 0, 1, 695, 295, 400
115b04c9e, 15, 0, 0, 1, 0, 1, 695, 155, 540
2af5106, 2, 4, 0, 1, 0, 1, 715, 495, 220
33094818a, 30, 10, 0, 1, 0, 1, 715, 275, 440
4fbdb38, 4, 10, 0, 1, 0, 1, 815, 395, 420
340091052, 40, 14, 0, 1, 0, 1, 815, 75, 740
2ff7e3fe8, ff, 13, 0, 1, 0, 1, 855, 435, 420
25327341f, 53, 3, 0, 1, 0, 1, 875, 315, 560
2538ba285, 53, 14, 0, 1, 0, 1, 915, 435, 480
45e21bf, 4, 8, 0, 1, 0, 1, 935, 95, 840
13520d94e, 35, 11, 0, 1, 0, 1, 935, 595, 340
2ce3610, 2, 15, 0, 1, 0, 1, 955, 195, 760
330fb6008, 30, 2, 0, 1, 0, 1, 955, 375, 580
34051fad5, 40, 13, 0, 1, 0, 1, 955, 75, 880
4d857c6, 4, 0, 0, 1, 0, 1, 975, 375, 600
2ff2eed3f, ff, 14, 0, 1, 0, 1, 1015, 595, 420
1155ad47f, 15, 3, 0, 1, 0, 1, 1015, 995, 20
340528360, 40, 8, 0, 1, 0, 1, 1035, 1015, 20
2532d222b, 53, 5, 0, 1, 0, 1, 1035, 655, 380
48323bc, 4, 12, 0, 1, 0, 1, 1055, 1035, 20
2ff040421, ff, 15, 0, 1, 0, 1, 1055, 1035, 20
13520d94e, 35, 0, 0, 0, 0, 0, 0, 0, 0
320d46462, 20, 13, 0, 1, 0, 1, 1095, 835, 260
115f9845a, 15, 14, 0, 1, 0, 1, 1095, 875, 220
2513663d1, 51, 0, 0, 1, 0, 1, 1115, 275, 840
135c04172, 35, 6, 0, 1, 0, 1, 1115, 855, 260
254dcfefb, 54, 2, 0, 1, 0, 1, 1135, 515, 620
340678630, 40, 10, 0, 1, 0, 1, 1155, 775, 380
253b97508, 53, 1, 0, 1, 0, 1, 1155, 455, 700
2ff7e3fe8, ff, 13, 0, 1, 0, 1, 1175, 435, 740
3108f7135, 10, 7, 0, 1, 0, 1, 1195, 635, 560
34b7104, 3, 0, 0, 1, 0, 1, 1215, 535, 680
330dc61cb, 30, 15, 0, 1, 0, 1, 1215, 395, 820
2ff48abfb, ff, 11, 0, 1, 0, 1, 1255, 1235, 20
272b13a, 2, 15, 0, 1, 0, 1, 1275, 555, 720
32040c8f3, 20, 9, 0, 1, 0, 1, 1275, 855, 420
48b643a, 4, 9, 0, 1, 0, 1, 1295, 475, 820
145d921bf, 45, 4, 0, 1, 0, 1, 1295, 235, 1060
2512864fa, 51, 11, 0, 1, 0, 1, 1315, 755, 560
330ad11f9, 30, 9, 0, 1, 0, 1, 1375, 995, 380
48fdc02, 4, 9, 0, 1, 0, 1, 1395, 595, 800
3207328e8, 20, 13, 0, 1, 0, 1, 1395, 975, 420
2287843, 2, 5, 0, 1, 0, 1, 1435, 1155, 280
145d921bf, 45, 0, 0, 0, 0, 0, 0, 0, 0
14bf977, 1, 3, 0, 1, 0, 1, 1475, 595, 880
340ff8422, 40, 15, 0, 1, 0, 1, 1475, 875, 600
3307d87b3, 30, 1, 0, 1, 0, 1, 1495, 735, 760
2ff16c50b, ff, 12, 0, 1, 0, 1, 1495, 475, 1020
13527be51, 35, 6, 0, 1, 0, 1, 1495, 1275, 220
32067efff, 20, 13, 0, 1, 0, 1, 1515, 1095, 420
115b968cf, 15, 6, 0, 1, 0, 1, 1515, 515, 1000
330ab3bdf, 30, 10, 0, 1, 0, 1, 1535, 935, 600
2ffef6569, ff, 15, 0, 1, 0, 1, 1535, 1515, 20
310b221c4, 10, 7, 0, 1, 0, 1, 1615, 1055, 560
254fc8109, 54, 8, 0, 1, 0, 1, 1615, 455, 1160
4ead679, 4, 9, 0, 1, 0, 1, 1635, 695, 940
320e418b2, 20, 10, 0, 1, 0, 1, 1635, 1235, 400
2519b75e0, 51, 15, 0, 1, 0, 1, 1635, 1195, 440
252410af3, 52, 5, 0, 1, 0, 1, 1655, 1295, 360
135fcb1e4, 35, 1, 0, 1, 0, 1, 1655, 1175, 480
2ca4402, 2, 13, 0, 1, 0, 1, 1695, 595, 1100
310836a5c, 10, 7, 0, 1, 0, 1, 1715, 1215, 500
3205a4cec, 20, 2, 0, 1, 0, 1, 1715, 655, 1060
11563abc5, 15, 8, 0, 1, 0, 1, 1715, 315, 1400
4efe9a3, 4, 2, 0, 1, 0, 1, 1755, 1635, 120
320a91d93, 20, 11, 0, 1, 0, 1, 1755, 915, 840
25130b0d9, 51, 14, 0, 1, 0, 1, 1755, 735, 1020
33019ca65, 30, 5, 0, 1, 0, 1, 1775, 1415, 360
254fc8109, 54, 0, 0, 0, 0, 0, 0, 0, 0
135cf4a93, 35, 1, 0, 1, 0, 1, 1775, 1335, 440
340a04aab, 40, 3, 0, 1, 0, 1, 1795, 435, 1360
12588b99c, 25, 12, 0, 1, 0, 1, 1795, 1455, 340
330b6d302, 30, 15, 0, 1, 0, 1, 1815, 715, 1100
2ff6e4132, ff, 3, 0, 1, 0, 1, 1815, 715, 1100
23cce41, 2, 2, 0, 1, 0, 1, 1835, 1095, 740
115c72461, 15, 11, 0, 1, 0, 1, 1875, 1075, 800
135a96cba, 35, 7, 0, 1, 0, 1, 1895, 1375, 520
33003c77c, 30, 0, 0, 1, 0, 1, 1915, 955, 960
115b968cf, 15, 0, 0, 0, 0, 0, 0, 0, 0
2ff7f58ba, ff, 7, 0, 1, 0, 1, 1935, 495, 1440
33085db41, 30, 1, 0, 1, 0, 1, 1955, 1495, 460
2ce3610, 2, 0, 0, 0, 0, 0, 0, 0, 0
2ffe59f90, ff, 14, 0, 1, 0, 1, 1975, 1175, 800
14bd0dd, 1, 4, 0, 1, 0, 1, 1995, 1975, 20
32f1be4, 3, 10, 0, 1, 0, 1, 1995, 1815, 180
115c72461, 15, 0, 0, 0, 0, 0, 0, 0, 0
320b84848, 20, 7, 0, 1, 0, 1, 2055, 1855, 200
135ec7af4, 35, 9, 0, 1, 0, 1, 2055, 1715, 340
33042bac3, 30, 5, 0, 1, 0, 1, 2075, 1575, 500
3402c44d8, 40, 0, 0, 1, 0, 1, 2075, 795, 1280
115a72fbd, 15, 5, 0, 1, 0, 1, 2075, 755, 1320
2ff31f70f, ff, 9, 0, 1, 0, 1, 2095, 1115, 980
27b232e, 2, 15, 0, 1, 0, 1, 2115, 1355, 760
330cd7ae8, 30, 14, 0, 1, 0, 1, 2115, 1555, 560
252820506, 52, 14, 0, 1, 0, 1, 2135, 1015, 1120
254ce509e, 54, 3, 0, 1, 0, 1, 2135, 835, 1300
3207999, 3, 9, 0, 1, 0, 1, 2155, 1275, 880
2536c0b52, 53, 8, 0, 1, 0, 1, 2155, 595, 1560
16d0068, 1, 5, 0, 1, 0, 1, 2215, 2075, 140
125943b04, 25, 1, 0, 1, 0, 1, 2215, 1775, 440
3306b6b7a, 30, 13, 0, 1, 0, 1, 2235, 1435, 800
115a72fbd, 15, 0, 0, 0, 0, 0, 0, 0, 0
145d921bf, 45, 0, 0, 0, 0, 0, 0, 0, 0
2525458ea, 52, 10, 0, 1, 0, 1, 2275, 1955, 320
1456e7454, 45, 6, 0, 1, 0, 1, 2295, 1115, 1180
3207999, 3, 0, 0, 0, 0, 0, 0, 0, 0
11563abc5, 15, 0, 0, 0, 0, 0, 0, 0, 0
135653547, 35, 12, 0, 1, 0, 1, 2355, 1195, 1160
34092d59a, 40, 6, 0, 1, 0, 1, 2375, 1595, 780
145a68a3a, 45, 11, 0, 1, 0, 1, 2375, 2355, 20
25273bd49, 52, 1, 0, 1, 0, 1, 2395, 2175, 220
145d921bf, 45, 0, 0, 0, 0, 0, 0, 0, 0
135ca323b, 35, 11, 0, 1, 0, 1, 2435, 2195, 240
310f8fec5, 10, 11, 0, 1, 0, 1, 2455, 435, 2020
25427ed92, 54, 1, 0, 1, 0, 1, 2455, 595, 1860
326d12f, 3, 5, 0, 1, 0, 1, 2475, 2195, 280
17dc1fd, 1, 10, 0, 1, 0, 1, 2495, 1515, 980
135078619, 35, 3, 0, 1, 0, 1, 2495, 1315, 1180
2329804, 2, 2, 0, 1, 0, 1, 2515, 1515, 1000
34068fd53, 40, 4, 0, 1, 0, 1, 2515, 915, 1600
1156145a4, 15, 14, 0, 1, 0, 1, 2515, 1795, 720
14590764b, 45, 1, 0, 1, 0, 1, 2575, 895, 1680
3f5cd1c, 3, 10, 0, 1, 0, 1, 2635, 2495, 140
3401a203d, 40, 14, 0, 1, 0, 1, 2635, 1675, 960
1351ebfae, 35, 3, 0, 1, 0, 1, 2635, 1415, 1220
252ef2c, 2, 2, 0, 1, 0, 1, 2655, 1735, 920
32043544c, 20, 4, 0, 1, 0, 1, 2675, 1635, 1040
135f99f86, 35, 15, 0, 1, 0, 1, 2675, 2635, 40
2ae314a, 2, 9, 0, 1, 0, 1, 2695, 2455, 240
310bbd62a, 10, 1, 0, 1, 0, 1, 2715, 2595, 120
32084a3ad, 20, 13, 0, 1, 0, 1, 2715, 2435, 280
115a22efb, 15, 0, 0, 1, 0, 1, 2715, 1255, 1460
2ff367589, ff, 9, 0, 1, 0, 1, 2735, 1395, 1340
115cbf394, 15, 3, 0, 1, 0, 1, 2755, 2735, 20
145084c88, 45, 5, 0, 1, 0, 1, 2775, 995, 1780
37b64c7, 3, 6, 0, 1, 0, 1, 2795, 2635, 160
10c94a5, 1, 12, 0, 1, 0, 1, 2835, 1655, 1180
32043544c, 20, 0, 0, 0, 0, 0, 0, 0, 0
2789fa4, 2, 8, 0, 1, 0, 1, 2855, 1495, 1360
320e159f7, 20, 11, 0, 1, 0, 1, 2875, 1875, 1000
330ba3086, 30, 13, 0, 1, 0, 1, 2875, 1675, 1200
11569c3de, 15, 4, 0, 1, 0, 1, 2875, 1375, 1500
25415fc10, 54, 6, 0, 1, 0, 1, 2935, 1855, 1080
318d6fa, 3, 5, 0, 1, 0, 1, 2955, 2475, 480
251e57201, 51, 2, 0, 1, 0, 1, 2955, 1895, 1060
25317eb46, 53, 1, 0, 1, 0, 1, 2975, 1915, 1060
1b44630, 1, 8, 0, 1, 0, 1, 2995, 1975, 1020
450533c, 4, 14, 0, 1, 0, 1, 2995, 1955, 1040
25ac341, 2, 13, 0, 1, 0, 1, 3015, 2715, 300
11569c3de, 15, 0, 0, 0, 0, 0, 0, 0, 0
265f425, 2, 4, 0, 1, 0, 1, 3055, 2075, 980
3107ef70d, 10, 0, 0, 1, 0, 1, 3075, 3055, 20
25167bda0, 51, 6, 0, 1, 0, 1, 3075, 2495, 580
11574cf06, 15, 3, 0, 1, 0, 1, 3075, 3055, 20
2ff71b1af, ff, 3, 0, 1, 0, 1, 3095, 1155, 1940
125d5d6ed, 25, 1, 0, 1, 0, 1, 3095, 2915, 180
340b40b1a, 40, 11, 0, 1, 0, 1, 3115, 1715, 1400
45681e5, 4, 15, 0, 1, 0, 1, 3155, 1835, 1320
320ebbe8d, 20, 15, 0, 1, 0, 1, 3155, 2155, 1000
33003a52d, 30, 14, 0, 1, 0, 1, 3175, 2995, 180
1151bb193, 15, 1, 0, 1, 0, 1, 3195, 2015, 1180
2c7c762, 2, 0, 0, 1, 0, 1, 3215, 2115, 1100
2534ff016, 53, 8, 0, 1, 0, 1, 3215, 1175, 2040
254a0cc57, 54, 1, 0, 1, 0, 1, 3215, 1055, 2160
1912ee9, 1, 13, 0, 1, 0, 1, 3235, 1575, 1660
25178f5c8, 51, 13, 0, 1, 0, 1, 3235, 1955, 1280
2ff47a85a, ff, 14, 0, 1, 0, 1, 3255, 2735, 520
13507ba02, 35, 13, 0, 1, 0, 1, 3255, 2115, 1140
330a26f23, 30, 2, 0, 1, 0, 1, 3335, 3015, 320
4992f5a, 4, 2, 0, 1, 0, 1, 3355, 2855, 500
310777807, 10, 2, 0, 1, 0, 1, 3355, 2215, 1140
12543f91e, 25, 11, 0, 1, 0, 1, 3355, 2515, 840
253b794e7, 53, 1, 0, 1, 0, 1, 3375, 1635, 1740
135c9dda0, 35, 1, 0, 1, 0, 1, 3375, 3075, 300
3100ff6f1, 10, 14, 0, 1, 0, 1, 3395, 2075, 1320
2514ba3fe, 51, 2, 0, 1, 0, 1, 3395, 815, 2580
3204fd2ae, 20, 12, 0, 1, 0, 1, 3415, 875, 2540
2ff4ff9d2, ff, 3, 0, 1, 0, 1, 3415, 1535, 1880
3102e03cb, 10, 0, 0, 1, 0, 1, 3475, 3455, 20
145893098, 45, 11, 0, 1, 0, 1, 3495, 3475, 20
100a72a, 1, 12, 0, 1, 0, 1, 3515, 1975, 1540
330462efc, 30, 10, 0, 1, 0, 1, 3515, 2095, 1420
135e4baae, 35, 9, 0, 1, 0, 1, 3535, 3395, 140
1748de2, 1, 11, 0, 1, 0, 1, 3555, 1395, 2160
340db4d6b, 40, 0, 0, 1, 0, 1, 3555, 1415, 2140
254779715, 54, 5, 0, 1, 0, 1, 3575, 1815, 1760
320c59bf2, 20, 10, 0, 1, 0, 1, 3595, 3315, 280
330117b42, 30, 5, 0, 1, 0, 1, 3595, 3215, 380
310e2665b, 10, 2, 0, 1, 0, 1, 3635, 2375, 1260
310a9cb7b, 10, 5, 0, 1, 0, 1, 3675, 2935, 740
3305c777d, 30, 10, 0, 1, 0, 1, 3675, 2195, 1480
25471d94e, 54, 8, 0, 1, 0, 1, 3695, 855, 2840
2516db115, 51, 2, 0, 1, 0, 1, 3715, 955, 2760
2542d5bc7, 54, 12, 0, 1, 0, 1, 3735, 1575, 2160
32085c400, 20, 1, 0, 1, 0, 1, 3755, 3375, 380
340aaabd7, 40, 15, 0, 1, 0, 1, 3755, 2315, 1440
253f69aa5, 53, 2, 0, 1, 0, 1, 3755, 3575, 180
2526eaf5c, 52, 13, 0, 1, 0, 1, 3775, 3435, 340
3a560f5, 3, 6, 0, 1, 0, 1, 3835, 1715, 2120
4c9733d, 4, 1, 0, 1, 0, 1, 3835, 2315, 1520
2ff05faa9, ff, 9, 0, 1, 0, 1, 3855, 1855, 2000
229c90b, 2, 10, 0, 1, 0, 1, 3895, 2775, 1120
25222a777, 52, 1, 0, 1, 0, 1, 3895, 3655, 240
2ffdd17f9, ff, 3, 0, 1, 0, 1, 3895, 1935, 1960
2510f489d, 51, 9, 0, 1, 0, 1, 3915, 3555, 360
330d2276c, 30, 9, 0, 1, 0, 1, 3935, 3795, 140
25278fe52, 52, 10, 0, 1, 0, 1, 3935, 2875, 1060
1352acab3, 35, 10, 0, 1, 0, 1, 3935, 2635, 1300
1748de2, 1, 0, 0, 0, 0, 0, 0, 0, 0
35d1284, 3, 9, 0, 1, 0, 1, 3955, 2155, 1800
42771c4, 4, 14, 0, 1, 0, 1, 3955, 2375, 1580
1bc864b, 1, 4, 0, 1, 0, 1, 3995, 3975, 20
4d69919, 4, 8, 0, 1, 0, 1, 3995, 1655, 2340
1353eab36, 35, 4, 0, 1, 0, 1, 3995, 1075, 2920
2c74214, 2, 13, 0, 1, 0, 1, 4015, 1815, 2200
2ff05faa9, ff, 9, 0, 1, 0, 1, 4015, 1855, 2160
2534c514e, 53, 4, 0, 1, 0, 1, 4035, 1875, 2160
2522063c1, 52, 5, 0, 1, 0, 1, 4055, 3815, 240
2ff1c1ba1, ff, 5, 0, 1, 0, 1, 4055, 1935, 2120
128ebe7, 1, 2, 0, 1, 0, 1, 4075, 2535, 1540
23a7309, 2, 0, 0, 1, 0, 1, 4075, 2935, 1140
1352acab3, 35, 0, 0, 0, 0, 0, 0, 0, 0
4046f04, 4, 13, 0, 1, 0, 1, 4115, 3155, 960
3a94de2, 3, 0, 0, 1, 0, 1, 4135, 2015, 2120
4d69919, 4, 0, 0, 0, 0, 0, 0, 0, 0
254b97ddd, 54, 10, 0, 1, 0, 1, 4175, 3155, 1020
26b8f39, 2, 6, 0, 1, 0, 1, 4195, 3995, 200
135e7e378, 35, 2, 0, 1, 0, 1, 4215, 4015, 200
14930ca, 1, 12, 0, 1, 0, 1, 4235, 2295, 1940
2021619, 2, 4, 0, 1, 0, 1, 4235, 3015, 1220
3cd20a0, 3, 9, 0, 1, 0, 1, 4275, 2875, 1400
310b47d84, 10, 8, 0, 1, 0, 1, 4275, 2135, 2140
2539c61bd, 53, 12, 0, 1, 0, 1, 4275, 2135, 2140
115255edd, 15, 14, 0, 1, 0, 1, 4275, 2515, 1760
4055d99, 4, 2, 0, 1, 0, 1, 4315, 3435, 880
320b1258a, 20, 12, 0, 1, 0, 1, 4335, 3415, 920
254de25f5, 54, 2, 0, 1, 0, 1, 4335, 2695, 1640
12573517b, 25, 8, 0, 1, 0, 1, 4335, 715, 3620
145ce592d, 45, 14, 0, 1, 0, 1, 4375, 3735, 640
310a1e4c7, 10, 1, 0, 1, 0, 1, 4395, 4255, 140
330507a64, 30, 11, 0, 1, 0, 1, 4395, 2035, 2360
253000b63, 53, 5, 0, 1, 0, 1, 4395, 3955, 440
310b78716, 10, 6, 0, 1, 0, 1, 4435, 2775, 1660
251753336, 51, 2, 0, 1, 0, 1, 4435, 1235, 3200
115830410, 15, 11, 0, 1, 0, 1, 4435, 2675, 1760
1457653ae, 45, 11, 0, 1, 0, 1, 4455, 4435, 20
45c6788, 4, 1, 0, 1, 0, 1, 4475, 2455, 2020
251d566f8, 51, 13, 0, 1, 0, 1, 4475, 1195, 3280
29fd2eb, 2, 9, 0, 1, 0, 1, 4495, 4255, 240
145f6dafd, 45, 2, 0, 1, 0, 1, 4495, 3155, 1340
252bcde9b, 52, 11, 0, 1, 0, 1, 4515, 2835, 1680
31d1543, 3, 6, 0, 1, 0, 1, 4535, 4135, 400
330507a64, 30, 0, 0, 0, 0, 0, 0, 0, 0
2ff24c73b, ff, 3, 0, 1, 0, 1, 4535, 2255, 2280
2533da193, 53, 5, 0, 1, 0, 1, 4555, 4095, 460
1db580a, 1, 7, 0, 1, 0, 1, 4595, 2315, 2280
4fc9fec, 4, 14, 0, 1, 0, 1, 4595, 2855, 1740
3404dd411, 40, 0, 0, 1, 0, 1, 4595, 2235, 2360
12573517b, 25, 0, 0, 0, 0, 0, 0, 0, 0
33081fc44, 30, 4, 0, 1, 0, 1, 4615, 2515, 2100
135d82f44, 35, 1, 0, 1, 0, 1, 4615, 4095, 520
2517b4246, 51, 9, 0, 1, 0, 1, 4635, 4535, 100
11541ed10, 15, 2, 0, 1, 0, 1, 4635, 3855, 780
231b1d1, 2, 13, 0, 1, 0, 1, 4655, 4275, 380
145d14de5, 45, 9, 0, 1, 0, 1, 4655, 2015, 2640
2e56656, 2, 5, 0, 1, 0, 1, 4695, 2615, 2080
36f7710, 3, 5, 0, 1, 0, 1, 4695, 4395, 300
2ff597f25, ff, 14, 0, 1, 0, 1, 4695, 3875, 820
1b080f4, 1, 11, 0, 1, 0, 1, 4715, 1555, 3160
2532cf67c, 53, 3, 0, 1, 0, 1, 4715, 3695, 1020
456dff6, 4, 15, 0, 1, 0, 1, 4755, 2795, 1960
320738179, 20, 13, 0, 1, 0, 1, 4795, 4535, 260
330e46d92, 30, 10, 0, 1, 0, 1, 4795, 4615, 180
252220854, 52, 14, 0, 1, 0, 1, 4795, 4415, 380
254c6c0e2, 54, 10, 0, 1, 0, 1, 4815, 3575, 1240
340553957, 40, 8, 0, 1, 0, 1, 4835, 4815, 20
354d5c6, 3, 10, 0, 1, 0, 1, 4855, 4295, 560
2ff06601c, ff, 2, 0, 1, 0, 1, 4855, 2055, 2800
19eef84, 1, 13, 0, 1, 0, 1, 4875, 2275, 2600
2532cf67c, 53, 0, 0, 0, 0, 0, 0, 0, 0
29fadba, 2, 12, 0, 1, 0, 1, 4915, 2935, 1980
42a48ce, 4, 10, 0, 1, 0, 1, 4915, 2355, 2560
135966941, 35, 6, 0, 1, 0, 1, 4915, 4695, 220
320f2d7bc, 20, 2, 0, 1, 0, 1, 4955, 4755, 200
252432922, 52, 0, 0, 1, 0, 1, 4955, 3175, 1780
330ae5f79, 30, 8, 0, 1, 0, 1, 4975, 3935, 1040
2ff9ed605, ff, 4, 0, 1, 0, 1, 4975, 655, 4320
25292e3d9, 52, 10, 0, 1, 0, 1, 4995, 3795, 1200
1155c6887, 15, 3, 0, 1, 0, 1, 4995, 4975, 20
19eef84, 1, 0, 0, 0, 0, 0, 0, 0, 0
330ff4a2c, 30, 14, 0, 1, 0, 1, 5095, 4675, 420
2d88fc7, 2, 4, 0, 1, 0, 1, 5115, 3695, 1420
2520e3f6c, 52, 1, 0, 1, 0, 1, 5115, 4715, 400
11588127f, 15, 6, 0, 1, 0, 1, 5115, 2015, 3100
3ff1bd3, 3, 6, 0, 1, 0, 1, 5175, 2175, 3000
25118174f, 51, 7, 0, 1, 0, 1, 5175, 5155, 20
2ffdde06b, ff, 12, 0, 1, 0, 1, 5175, 2615, 2560
3203308e0, 20, 1, 0, 1, 0, 1, 5195, 3795, 1400
2510965a5, 51, 5, 0, 1, 0, 1, 5215, 3655, 1560
4943b8e, 4, 11, 0, 1, 0, 1, 5235, 2995, 2240
310593206, 10, 6, 0, 1, 0, 1, 5235, 3235, 2000
254a623, 2, 0, 0, 1, 0, 1, 5255, 3855, 1400
33093f56d, 30, 13, 0, 1, 0, 1, 5255, 3575, 1680
13517e837, 35, 13, 0, 1, 0, 1, 5255, 3715, 1540
14557ec68, 45, 11, 0, 1, 0, 1, 5255, 5235, 20
41448e5, 4, 2, 0, 1, 0, 1, 5275, 4435, 840
3bf048e, 3, 1, 0, 1, 0, 1, 5315, 3955, 1360
3203308e0, 20, 0, 0, 0, 0, 0, 0, 0, 0
4d08c03, 4, 12, 0, 1, 0, 1, 5355, 5335, 20
2510965a5, 51, 0, 0, 0, 0, 0, 0, 0, 0
25231c848, 52, 7, 0, 1, 0, 1, 5355, 3815, 1540
2ff1e8f66, ff, 15, 0, 1, 0, 1, 5375, 5355, 20
3024e63, 3, 3, 0, 1, 0, 1, 5395, 4495, 900
310287cf1, 10, 15, 0, 1, 0, 1, 5395, 1675, 3720
33093f56d, 30, 0, 0, 0, 0, 0, 0, 0, 0
3411c1d, 3, 10, 0, 1, 0, 1, 5435, 5075, 360
47ca522, 4, 0, 0, 1, 0, 1, 5435, 2555, 2880
253ab225e, 53, 2, 0, 1, 0, 1, 5455, 5195, 260
254e15f8e, 54, 9, 0, 1, 0, 1, 5455, 2295, 3160
3105523bd, 10, 0, 0, 1, 0, 1, 5475, 5455, 20
14542f1ad, 45, 3, 0, 1, 0, 1, 5495, 3215, 2280
1687241, 1, 1, 0, 1, 0, 1, 5515, 4995, 520
340624de8, 40, 0, 0, 1, 0, 1, 5515, 2395, 3120
3024e63, 3, 0, 0, 0, 0, 0, 0, 0, 0
310fb34a6, 10, 6, 0, 1, 0, 1, 5555, 3535, 2020
11575f6e8, 15, 5, 0, 1, 0, 1, 5555, 4235, 1320
125421f1d, 25, 9, 0, 1, 0, 1, 5575, 1555, 4020
145542c87, 45, 11, 0, 1, 0, 1, 5575, 5555, 20
27a5ed9, 2, 2, 0, 1, 0, 1, 5595, 4295, 1300
125818eb5, 25, 9, 0, 1, 0, 1, 5615, 5295, 320
145a3f559, 45, 0, 0, 1, 0, 1, 5615, 695, 4920
2274c37, 2, 6, 0, 1, 0, 1, 5635, 5315, 320
3104d734d, 10, 0, 0, 1, 0, 1, 5635, 5615, 20
34086140e, 40, 6, 0, 1, 0, 1, 5635, 4555, 1080
3209428b3, 20, 14, 0, 1, 0, 1, 5655, 4015, 1640
14542f1ad, 45, 0, 0, 0, 0, 0, 0, 0, 0
1f02830, 1, 13, 0, 1, 0, 1, 5675, 2575, 3100
274394c, 2, 4, 0, 1, 0, 1, 5675, 4455, 1220
330e080, 3, 12, 0, 1, 0, 1, 5695, 4535, 1160
4c05290, 4, 14, 0, 1, 0, 1, 5715, 3595, 2120
33098755d, 30, 12, 0, 1, 0, 1, 5735, 3255, 2480
14b9ed7, 1, 4, 0, 1, 0, 1, 5755, 5735, 20
115b34d1d, 15, 5, 0, 1, 0, 1, 5755, 2335, 3420
330eed166, 30, 7, 0, 1, 0, 1, 5775, 4255, 1520
222be16, 2, 7, 0, 1, 0, 1, 5795, 3975, 1820
251941cc8, 51, 4, 0, 1, 0, 1, 5795, 2775, 3020
320f2cdbd, 20, 10, 0, 1, 0, 1, 5815, 5215, 600
1456c5eff, 45, 14, 0, 1, 0, 1, 5815, 5275, 540
25403437d, 54, 15, 0, 1, 0, 1, 5855, 5835, 20
1cc0ca6, 1, 5, 0, 1, 0, 1, 5875, 4555, 1320
4ea424a, 4, 15, 0, 1, 0, 1, 5875, 3115, 2760
4d20365, 4, 2, 0, 1, 0, 1, 5915, 5335, 580
3306eea36, 30, 10, 0, 1, 0, 1, 5935, 3035, 2900
25443c139, 54, 7, 0, 1, 0, 1, 5935, 1535, 4400
222be16, 2, 0, 0, 0, 0, 0, 0, 0, 0
251941cc8, 51, 0, 0, 0, 0, 0, 0, 0, 0
320c7b870, 20, 3, 0, 1, 0, 1, 5975, 5135, 840
1456c5eff, 45, 0, 0, 0, 0, 0, 0, 0, 0
1168662, 1, 12, 0, 1, 0, 1, 5995, 3575, 2420
2538068b0, 53, 8, 0, 1, 0, 1, 6015, 2275, 3740
4fca1d8, 4, 11, 0, 1, 0, 1, 6035, 3155, 2880
125b5a7a1, 25, 2, 0, 1, 0, 1, 6055, 5935, 120
4d20365, 4, 0, 0, 0, 0, 0, 0, 0, 0
2fff0f2be, ff, 9, 0, 1, 0, 1, 6095, 2735, 3360
1e78ac0, 1, 13, 0, 1, 0, 1, 6155, 2995, 3160
369770d, 3, 15, 0, 1, 0, 1, 6175, 5675, 500
320416bc6, 20, 6, 0, 1, 0, 1, 6175, 5155, 1020
1815ddd, 1, 6, 0, 1, 0, 1, 6195, 3835, 2360
336f95a, 3, 0, 0, 1, 0, 1, 6215, 4175, 2040
145251d11, 45, 7, 0, 1, 0, 1, 6255, 1695, 4560
2c3a70b, 2, 7, 0, 1, 0, 1, 6275, 2455, 3820
2520aa3ef, 52, 1, 0, 1, 0, 1, 6275, 6015, 260
320d8338a, 20, 3, 0, 1, 0, 1, 6295, 5455, 840
310dc864f, 10, 9, 0, 1, 0, 1, 6315, 5455, 860
353a75f, 3, 13, 0, 1, 0, 1, 6335, 5815, 520
32052418b, 20, 15, 0, 1, 0, 1, 6335, 2475, 3860
1837d45, 1, 8, 0, 1, 0, 1, 6355, 3295, 3060
46cd0ac, 4, 11, 0, 1, 0, 1, 6355, 3315, 3040
145cd1bba, 45, 11, 0, 1, 0, 1, 6375, 6355, 20
48bde29, 4, 2, 0, 1, 0, 1, 6395, 5495, 900
3401dd50b, 40, 13, 0, 1, 0, 1, 6435, 3995, 2440
2525e0dc3, 52, 5, 0, 1, 0, 1, 6435, 6195, 240
2ff38fcc6, ff, 13, 0, 1, 0, 1, 6455, 3855, 2600
3105e0b9e, 10, 2, 0, 1, 0, 1, 6475, 4595, 1880
252735bba, 52, 11, 0, 1, 0, 1, 6475, 4595, 1880
253f41ad4, 53, 15, 0, 1, 0, 1, 6475, 6155, 320
31064d2, 3, 14, 0, 1, 0, 1, 6495, 6255, 240
32052418b, 20, 0, 0, 0, 0, 0, 0, 0, 0
330016304, 30, 10, 0, 1, 0, 1, 6495, 3455, 3040
1837d45, 1, 0, 0, 0, 0, 0, 0, 0, 0
47ee943, 4, 5, 0, 1, 0, 1, 6515, 5015, 1500
1154a469f, 15, 4, 0, 1, 0, 1, 6555, 3415, 3140
145251d11, 45, 0, 0, 0, 0, 0, 0, 0, 0
3402da24f, 40, 0, 0, 1, 0, 1, 6595, 3295, 3300
1975058, 1, 12, 0, 1, 0, 1, 6635, 3735, 2900
251096262, 51, 9, 0, 1, 0, 1, 6635, 6035, 600
351cef9, 3, 6, 0, 1, 0, 1, 6655, 6195, 460
310586efe, 10, 15, 0, 1, 0, 1, 6675, 1995, 4680
19007b9, 1, 4, 0, 1, 0, 1, 6715, 6695, 20
11567e249, 15, 0, 0, 1, 0, 1, 6715, 3575, 3140
145034b1c, 45, 10, 0, 1, 0, 1, 6735, 4935, 1800
320df296f, 20, 13, 0, 1, 0, 1, 6755, 6535, 220
3405dd7d0, 40, 0, 0, 1, 0, 1, 6755, 3735, 3020
3300bb8cd, 30, 7, 0, 1, 0, 1, 6775, 5015, 1760
2ff7d47aa, ff, 4, 0, 1, 0, 1, 6775, 1735, 5040
1c40a13, 1, 1, 0, 1, 0, 1, 6795, 6295, 500
40c6696, 4, 15, 0, 1, 0, 1, 6835, 3595, 3240
310586efe, 10, 0, 0, 0, 0, 0, 0, 0, 0
330e7b066, 30, 10, 0, 1, 0, 1, 6855, 6635, 220
320c171f5, 20, 4, 0, 1, 0, 1, 6875, 4935, 1940
252719b84, 52, 4, 0, 1, 0, 1, 6875, 5255, 1620
135211161, 35, 15, 0, 1, 0, 1, 6875, 6315, 560
3403c6eeb, 40, 14, 0, 1, 0, 1, 6915, 4975, 1940
13523195f, 35, 5, 0, 1, 0, 1, 6935, 4695, 2240
145808bb3, 45, 14, 0, 1, 0, 1, 6935, 5695, 1240
1150f0c, 1, 2, 0, 1, 0, 1, 6955, 4915, 2040
4e72ccc, 4, 15, 0, 1, 0, 1, 6995, 3755, 3240
3104841ce, 10, 13, 0, 1, 0, 1, 6995, 5215, 1780
2521d899d, 52, 3, 0, 1, 0, 1, 6995, 4175, 2820
320e7b21b, 20, 0, 0, 1, 0, 1, 7015, 4975, 2040
330d48716, 30, 9, 0, 1, 0, 1, 7015, 6775, 240
115d29c6c, 15, 9, 0, 1, 0, 1, 7035, 5015, 2020
145874c83, 45, 9, 0, 1, 0, 1, 7055, 3155, 3900
251ce9412, 51, 5, 0, 1, 0, 1, 7075, 4855, 2220
1251fcc77, 25, 5, 0, 1, 0, 1, 7075, 6815, 260
14524d754, 45, 13, 0, 1, 0, 1, 7095, 4135, 2960
44f6779, 4, 12, 0, 1, 0, 1, 7115, 7095, 20
34073f3b2, 40, 15, 0, 1, 0, 1, 7115, 4555, 2560
252ade800, 52, 8, 0, 1, 0, 1, 7115, 4975, 2140
253e44674, 53, 7, 0, 1, 0, 1, 7115, 2855, 4260
254496537, 54, 15, 0, 1, 0, 1, 7135, 7115, 20
320304363, 20, 4, 0, 1, 0, 1, 7155, 5095, 2060
25279204c, 52, 13, 0, 1, 0, 1, 7155, 6835, 320
1150c1270, 15, 7, 0, 1, 0, 1, 7155, 895, 6260
135d7c676, 35, 15, 0, 1, 0, 1, 7155, 6475, 680
330abe971, 30, 12, 0, 1, 0, 1, 7175, 4375, 2800
4edb52d, 4, 5, 0, 1, 0, 1, 7195, 3055, 4140
320542ea6, 20, 7, 0, 1, 0, 1, 7215, 4375, 2840
2fffff613, ff, 4, 0, 1, 0, 1, 7215, 755, 6460
34016f3a2, 40, 3, 0, 1, 0, 1, 7235, 2095, 5140
310a9697a, 10, 2, 0, 1, 0, 1, 7275, 5055, 2220
253d95878, 53, 0, 0, 1, 0, 1, 7275, 1115, 6160
39aedc4, 3, 13, 0, 1, 0, 1, 7315, 5075, 2240
2521d899d, 52, 0, 0, 0, 0, 0, 0, 0, 0
320da6b48, 20, 2, 0, 1, 0, 1, 7335, 6995, 340
2537b6ed5, 53, 11, 0, 1, 0, 1, 7335, 6995, 340
4181747, 4, 1, 0, 1, 0, 1, 7355, 5695, 1660
320542ea6, 20, 0, 0, 0, 0, 0, 0, 0, 0
3109d877d, 10, 0, 0, 1, 0, 1, 7395, 7375, 20
3404bb4a5, 40, 14, 0, 1, 0, 1, 7395, 5135, 2260
25353f5, 2, 0, 0, 1, 0, 1, 7415, 5935, 1480
253d95878, 53, 0, 0, 0, 0, 0, 0, 0, 0
1455e4a57, 45, 2, 0, 1, 0, 1, 7415, 3295, 4120
25107610b, 51, 11, 0, 1, 0, 1, 7435, 5075, 2360
2ff1e6695, ff, 15, 0, 1, 0, 1, 7455, 7435, 20
1366fa5, 1, 9, 0, 1, 0, 1, 7475, 3675, 3800
252426e1f, 52, 14, 0, 1, 0, 1, 7475, 6955, 520
4181747, 4, 0, 0, 0, 0, 0, 0, 0, 0
340098bf5, 40, 13, 0, 1, 0, 1, 7555, 4935, 2620
254ba070c, 54, 13, 0, 1, 0, 1, 7575, 4415, 3160
25107610b, 51, 0, 0, 0, 0, 0, 0, 0, 0
330d2b201, 30, 1, 0, 1, 0, 1, 7615, 7435, 180
12522af3c, 25, 8, 0, 1, 0, 1, 7615, 1335, 6280
3101386f8, 10, 7, 0, 1, 0, 1, 7635, 4095, 3540
34ae30e, 3, 13, 0, 1, 0, 1, 7655, 7415, 240
25287d8bf, 52, 11, 0, 1, 0, 1, 7655, 5395, 2260
254eb7de6, 54, 6, 0, 1, 0, 1, 7695, 1435, 6260
25255587d, 52, 8, 0, 1, 0, 1, 7735, 5255, 2480
145e2637a, 45, 12, 0, 1, 0, 1, 7735, 4055, 3680
1f41139, 1, 3, 0, 1, 0, 1, 7755, 4335, 3420
32053b55e, 20, 1, 0, 1, 0, 1, 7755, 5395, 2360
253e5a2fc, 53, 1, 0, 1, 0, 1, 7775, 4395, 3380
40c7508, 4, 6, 0, 1, 0, 1, 7795, 4855, 2940
31003404a, 10, 13, 0, 1, 0, 1, 7795, 5955, 1840
13584559b, 35, 13, 0, 1, 0, 1, 7815, 5515, 2300
49fe85f, 4, 1, 0, 1, 0, 1, 7835, 5855, 1980
2549a605f, 54, 1, 0, 1, 0, 1, 7855, 3235, 4620
2ff2b16c4, ff, 14, 0, 1, 0, 1, 7895, 6535, 1360
1b5fc32, 1, 3, 0, 1, 0, 1, 7915, 4655, 3260
3305c55ea, 30, 15, 0, 1, 0, 1, 7935, 4235, 3700
252068b03, 52, 11, 0, 1, 0, 1, 7935, 5715, 2220
135a7ddff, 35, 2, 0, 1, 0, 1, 7935, 7555, 380
45dc6e3, 4, 15, 0, 1, 0, 1, 7955, 4075, 3880
25377ad8d, 53, 13, 0, 1, 0, 1, 7955, 7555, 400
13584559b, 35, 0, 0, 0, 0, 0, 0, 0, 0
49fe85f, 4, 0, 0, 0, 0, 0, 0, 0, 0
145667bfb, 45, 10, 0, 1, 0, 1, 8015, 5955, 2060
2531761d6, 53, 7, 0, 1, 0, 1, 8035, 3015, 5020
2520de233, 52, 2, 0, 1, 0, 1, 8055, 6395, 1660
2540e5793, 54, 13, 0, 1, 0, 1, 8055, 4675, 3380
29cb163, 2, 12, 0, 1, 0, 1, 8075, 5495, 2580
320cbd88b, 20, 9, 0, 1, 0, 1, 8075, 7815, 260
3404ab7ad, 40, 9, 0, 1, 0, 1, 8075, 7215, 860
253386c32, 53, 6, 0, 1, 0, 1, 8075, 7815, 260
1e61f93, 1, 8, 0, 1, 0, 1, 8115, 4215, 3900
2fe6723, 2, 4, 0, 1, 0, 1, 8135, 7015, 1120
14935d7, 1, 4, 0, 1, 0, 1, 8155, 8135, 20
4c926fe, 4, 8, 0, 1, 0, 1, 8155, 2415, 5740
2512f188f, 51, 14, 0, 1, 0, 1, 8195, 5975, 2220
252753fa7, 52, 6, 0, 1, 0, 1, 8215, 7955, 260
25442ae04, 54, 12, 0, 1, 0, 1, 8215, 4695, 3520
1bc5af4, 1, 15, 0, 1, 0, 1, 8235, 2955, 5280
31c590a, 3, 13, 0, 1, 0, 1, 8235, 7975, 260
340fcc2d9, 40, 12, 0, 1, 0, 1, 8235, 2775, 5460
29ee6d0, 2, 9, 0, 1, 0, 1, 8255, 8115, 140
1e61f93, 1, 0, 0, 0, 0, 0, 0, 0, 0
4eadb81, 4, 15, 0, 1, 0, 1, 8275, 4715, 3560
340abc3a8, 40, 8, 0, 1, 0, 1, 8275, 8255, 20
4c926fe, 4, 0, 0, 0, 0, 0, 0, 0, 0
13594f5ea, 35, 11, 0, 1, 0, 1, 8335, 7315, 1020
251f788bf, 51, 5, 0, 1, 0, 1, 8355, 5395, 2960
252996e8c, 52, 1, 0, 1, 0, 1, 8375, 8155, 220
2ffe3e231, ff, 14, 0, 1, 0, 1, 8375, 7095, 1280
1bc5af4, 1, 0, 0, 0, 0, 0, 0, 0, 0
251d62b33, 51, 2, 0, 1, 0, 1, 8395, 5635, 2760
1bf114f, 1, 6, 0, 1, 0, 1, 8435, 5795, 2640
135493a6e, 35, 7, 0, 1, 0, 1, 8475, 2175, 6300
330d5cd34, 30, 14, 0, 1, 0, 1, 8495, 8275, 220
34030f8c0, 40, 0, 0, 1, 0, 1, 8515, 4015, 4500
1258ed8da, 25, 5, 0, 1, 0, 1, 8515, 8275, 240
19751f2, 1, 9, 0, 1, 0, 1, 8555, 7375, 1180
2519092c2, 51, 9, 0, 1, 0, 1, 8555, 7675, 880
1bf114f, 1, 0, 0, 0, 0, 0, 0, 0, 0
1159fe68c, 15, 15, 0, 1, 0, 1, 8595, 4875, 3720
135493a6e, 35, 0, 0, 0, 0, 0, 0, 0, 0
252978eec, 52, 6, 0, 1, 0, 1, 8655, 4995, 3660
145885e1d, 45, 2, 0, 1, 0, 1, 8655, 6235, 2420
3308e7568, 30, 7, 0, 1, 0, 1, 8675, 6215, 2460
252638827, 52, 3, 0, 1, 0, 1, 8695, 5775, 2920
1359610ed, 35, 13, 0, 1, 0, 1, 8695, 6255, 2440
1b9bad1, 1, 1, 0, 1, 0, 1, 8715, 7595, 1120
320b02927, 20, 0, 0, 1, 0, 1, 8755, 6895, 1860
11561e6ed, 15, 11, 0, 1, 0, 1, 8755, 4915, 3840
135493a6e, 35, 0, 0, 0, 0, 0, 0, 0, 0
320e86ad2, 20, 10, 0, 1, 0, 1, 8795, 8415, 380
253e119e2, 53, 1, 0, 1, 0, 1, 8855, 5135, 3720
3104494cb, 10, 13, 0, 1, 0, 1, 8915, 7255, 1660
3205c2258, 20, 3, 0, 1, 0, 1, 8915, 3855, 5060
1150d9fea, 15, 5, 0, 1, 0, 1, 8915, 6955, 1960
2512183, 2, 12, 0, 1, 0, 1, 8955, 5975, 2980
320ebebf8, 20, 11, 0, 1, 0, 1, 8955, 6035, 2920
115b98985, 15, 10, 0, 1, 0, 1, 8955, 7055, 1900
253e119e2, 53, 0, 0, 0, 0, 0, 0, 0, 0
2ff531ae4, ff, 9, 0, 1, 0, 1, 8975, 3955, 5020
2520f6757, 52, 14, 0, 1, 0, 1, 8995, 8715, 280
25347ce50, 53, 5, 0, 1, 0, 1, 9015, 8695, 320
14539427b, 45, 6, 0, 1, 0, 1, 9015, 7375, 1640
1d2fc96, 1, 14, 0, 1, 0, 1, 9035, 3435, 5600
251540941, 51, 15, 0, 1, 0, 1, 9035, 5995, 3040
330221bf8, 30, 15, 0, 1, 0, 1, 9095, 4395, 4700
1258069d4, 25, 12, 0, 1, 0, 1, 9095, 8055, 1040
3c35293, 3, 13, 0, 1, 0, 1, 9115, 6395, 2720
4b22583, 4, 1, 0, 1, 0, 1, 9115, 6435, 2680
320d394c2, 20, 9, 0, 1, 0, 1, 9115, 8595, 520
253b7591f, 53, 6, 0, 1, 0, 1, 9135, 3075, 6060
254cc2f79, 54, 7, 0, 1, 0, 1, 9135, 2735, 6400
38f64c7, 3, 10, 0, 1, 0, 1, 9155, 8695, 460
251316604, 51, 5, 0, 1, 0, 1, 9155, 5715, 3440
2534ab59c, 53, 1, 0, 1, 0, 1, 9175, 7155, 2020
135237727, 35, 5, 0, 1, 0, 1, 9175, 6355, 2820
14539427b, 45, 0, 0, 0, 0, 0, 0, 0, 0
1e5103d, 1, 2, 0, 1, 0, 1, 9195, 6715, 2480
3edd3a4, 3, 4, 0, 1, 0, 1, 9195, 6055, 3140
251540941, 51, 0, 0, 0, 0, 0, 0, 0, 0
252da2a20, 52, 14, 0, 1, 0, 1, 9195, 5555, 3640
330964c96, 30, 11, 0, 1, 0, 1, 9215, 7635, 1580
330bff81d, 30, 7, 0, 1, 0, 1, 9255, 6855, 2400
2ff24f9cd, ff, 11, 0, 1, 0, 1, 9255, 9235, 20
320e035f8, 20, 10, 0, 1, 0, 1, 9275, 8795, 480
253bdefcf, 53, 5, 0, 1, 0, 1, 9295, 2775, 6520
2ff31d824, ff, 10, 0, 1, 0, 1, 9295, 6775, 2520
3014b83, 3, 5, 0, 1, 0, 1, 9315, 9015, 300
320edea66, 20, 7, 0, 1, 0, 1, 9315, 5735, 3580
1151e5a79, 15, 3, 0, 1, 0, 1, 9315, 9295, 20
330037d0b, 30, 5, 0, 1, 0, 1, 9335, 7555, 1780
1457bdb17, 45, 6, 0, 1, 0, 1, 9335, 7515, 1820
251f399e9, 51, 3, 0, 1, 0, 1, 9355, 3375, 5980
33095b3ce, 30, 10, 0, 1, 0, 1, 9375, 8915, 460
3409e3cb4, 40, 8, 0, 1, 0, 1, 9395, 9375, 20
1153c38aa, 15, 10, 0, 1, 0, 1, 9395, 3935, 5460
4df1cb7, 4, 0, 0, 1, 0, 1, 9435, 5295, 4140
3209096de, 20, 1, 0, 1, 0, 1, 9435, 9195, 240
115b94dd6, 15, 3, 0, 1, 0, 1, 9475, 9455, 20
1358273bc, 35, 12, 0, 1, 0, 1, 9495, 6295, 3200
1457bdb17, 45, 0, 0, 0, 0, 0, 0, 0, 0
251f399e9, 51, 0, 0, 0, 0, 0, 0, 0, 0
125587dec, 25, 0, 0, 1, 0, 1, 9515, 5135, 4380
330964c96, 30, 0, 0, 0, 0, 0, 0, 0, 0
145b269, 1, 14, 0, 1, 0, 1, 9555, 6115, 3440
253b2c1, 2, 9, 0, 1, 0, 1, 9575, 9375, 200
2534c3359, 53, 14, 0, 1, 0, 1, 9575, 9195, 380
1157ec6e9, 15, 2, 0, 1, 0, 1, 9595, 7715, 1880
3406c3541, 40, 5, 0, 1, 0, 1, 9635, 5875, 3760
2525bc6f7, 52, 3, 0, 1, 0, 1, 9635, 6255, 3380
1351afa9d, 35, 13, 0, 1, 0, 1, 9635, 6975, 2660
2540209c2, 54, 2, 0, 1, 0, 1, 9655, 4155, 5500
125587dec, 25, 0, 0, 0, 0, 0, 0, 0, 0
340472649, 40, 9, 0, 1, 0, 1, 9675, 8755, 920
2ff20adf4, ff, 15, 0, 1, 0, 1, 9695, 9675, 20
310d80fc2, 10, 6, 0, 1, 0, 1, 9715, 6515, 3200
115521eda, 15, 15, 0, 1, 0, 1, 9715, 5515, 4200
135cdd82d, 35, 11, 0, 1, 0, 1, 9715, 8435, 1280
1255a6f15, 25, 8, 0, 1, 0, 1, 9735, 1815, 7920
4c5a0c4, 4, 9, 0, 1, 0, 1, 9755, 6635, 3120
13519db1f, 35, 6, 0, 1, 0, 1, 9755, 9435, 320
3944baa, 3, 0, 0, 1, 0, 1, 9775, 6415, 3360
2ffa0e954, ff, 6, 0, 1, 0, 1, 9775, 2335, 7440
2525bc6f7, 52, 0, 0, 0, 0, 0, 0, 0, 0
125e27848, 25, 12, 0, 1, 0, 1, 9795, 8695, 1100
254be10b7, 54, 14, 0, 1, 0, 1, 9815, 7995, 1820
4de5c96, 4, 12, 0, 1, 0, 1, 9835, 9815, 20
32041c6db, 20, 4, 0, 1, 0, 1, 9835, 7655, 2180
340472649, 40, 0, 0, 0, 0, 0, 0, 0, 0
252faaa3b, 52, 10, 0, 1, 0, 1, 9835, 7595, 2240
471c15a, 4, 14, 0, 1, 0, 1, 9875, 6395, 3480
31053a70d, 10, 11, 0, 1, 0, 1, 9875, 3635, 6240
135e8dc7a, 35, 0, 0, 1, 0, 1, 9895, 5775, 4120
2ffcac734, ff, 2, 0, 1, 0, 1, 9935, 6855, 3080
13513a612, 35, 13, 0, 1, 0, 1, 9935, 7135, 2800
32062c226, 20, 1, 0, 1, 0, 1, 9955, 7295, 2660
2523c0bd0, 52, 14, 0, 1, 0, 1, 9955, 9515, 440
33052b433, 30, 14, 0, 1, 0, 1, 9975, 9655, 320
2ff7a8d32, ff, 1, 0, 1, 0, 1, 9975, 3515, 6460
176740d, 1, 11, 0, 1, 0, 1, 10035, 3795, 6240
4e32871, 4, 13, 0, 1, 0, 1, 10035, 8115, 1920
135d07d29, 35, 0, 0, 1, 0, 1, 10035, 6255, 3780
3910406, 3, 3, 0, 1, 0, 1, 10075, 8335, 1740
115df6207, 15, 1, 0, 1, 0, 1, 10075, 6875, 3200
2522aa5b9, 52, 5, 0, 1, 0, 1, 10095, 9495, 600
254242f04, 54, 9, 0, 1, 0, 1, 10095, 4395, 5700
2514ff642, 51, 0, 0, 1, 0, 1, 10115, 4495, 5620
1356051e5, 35, 10, 0, 1, 0, 1, 10135, 6495, 3640
253d4bb1c, 53, 5, 0, 1, 0, 1, 10155, 3355, 6800
135d07d29, 35, 0, 0, 0, 0, 0, 0, 0, 0
310876e78, 10, 6, 0, 1, 0, 1, 10195, 6915, 3280
1156acef4, 15, 9, 0, 1, 0, 1, 10195, 2595, 7600
25391c743, 53, 13, 0, 1, 0, 1, 10215, 5375, 4840
252154b2f, 52, 0, 0, 1, 0, 1, 10235, 8015, 2220
1158c31d3, 15, 2, 0, 1, 0, 1, 10235, 8135, 2100
3402b9947, 40, 13, 0, 1, 0, 1, 10255, 5675, 4580
1451056e4, 45, 4, 0, 1, 0, 1, 10255, 2615, 7640
135b9a591, 35, 11, 0, 1, 0, 1, 10275, 8915, 1360
251a9c984, 51, 1, 0, 1, 0, 1, 10295, 8735, 1560
1b7048c, 1, 7, 0, 1, 0, 1, 10315, 5455, 4860
115617520, 15, 5, 0, 1, 0, 1, 10315, 7975, 2340
135d07d29, 35, 0, 0, 0, 0, 0, 0, 0, 0
2525e084b, 52, 2, 0, 1, 0, 1, 10335, 8295, 2040
343b767, 3, 11, 0, 1, 0, 1, 10355, 9075, 1280
1152794fa, 15, 4, 0, 1, 0, 1, 10355, 5575, 4780
2f73db0, 2, 6, 0, 1, 0, 1, 10375, 5955, 4420
34044d076, 40, 3, 0, 1, 0, 1, 10375, 2415, 7960
25210d9c3, 52, 11, 0, 1, 0, 1, 10375, 7795, 2580
2ff4f9d96, ff, 14, 0, 1, 0, 1, 10375, 8555, 1820
130cb30, 1, 2, 0, 1, 0, 1, 10395, 7995, 2400
2539dc46d, 53, 9, 0, 1, 0, 1, 10395, 6895, 3500
3400936a9, 40, 11, 0, 1, 0, 1, 10415, 6835, 3580
10a18f0, 1, 10, 0, 1, 0, 1, 10435, 4075, 6360
422394b, 4, 11, 0, 1, 0, 1, 10435, 5875, 4560
254a13302, 54, 2, 0, 1, 0, 1, 10455, 7415, 3040
115b9d4fd, 15, 10, 0, 1, 0, 1, 10475, 8135, 2340
340aee301, 40, 5, 0, 1, 0, 1, 10495, 6515, 3980
25479ab43, 54, 6, 0, 1, 0, 1, 10495, 8095, 2400
130cb30, 1, 0, 0, 0, 0, 0, 0, 0, 0
3a6a6eb, 3, 9, 0, 1, 0, 1, 10515, 8435, 2080
1024341, 1, 11, 0, 1, 0, 1, 10555, 4115, 6440
28e8d9a, 2, 11, 0, 1, 0, 1, 10555, 3955, 6600
330ade94b, 30, 0, 0, 1, 0, 1, 10555, 7215, 3340
25221c78e, 52, 4, 0, 1, 0, 1, 10555, 8455, 2100
40b5354, 4, 1, 0, 1, 0, 1, 10595, 7015, 3580
320fb1fe9, 20, 14, 0, 1, 0, 1, 10595, 8415, 2180
1359278d0, 35, 13, 0, 1, 0, 1, 10595, 7695, 2900
25180cc27, 51, 6, 0, 1, 0, 1, 10615, 8395, 2220
1452a6b5c, 45, 6, 0, 1, 0, 1, 10615, 8235, 2380
2525e084b, 52, 0, 0, 0, 0, 0, 0, 0, 0
12569dd4d, 25, 6, 0, 1, 0, 1, 10655, 8555, 2100
1354fb2ac, 35, 15, 0, 1, 0, 1, 10655, 9355, 1300
1024341, 1, 0, 0, 0, 0, 0, 0, 0, 0
2c33d23, 2, 12, 0, 1, 0, 1, 10675, 7415, 3260
330ade94b, 30, 0, 0, 0, 0, 0, 0, 0, 0
3494068, 3, 12, 0, 1, 0, 1, 10695, 9175, 1520
25209e4e2, 52, 15, 0, 1, 0, 1, 10695, 7915, 2780
125937e3c, 25, 6, 0, 1, 0, 1, 10695, 8975, 1720
45acb12, 4, 2, 0, 1, 0, 1, 10715, 8455, 2260
13550e2c7, 35, 3, 0, 1, 0, 1, 10715, 7215, 3500
340ed66df, 40, 4, 0, 1, 0, 1, 10735, 4775, 5960
2522b1d5f, 52, 8, 0, 1, 0, 1, 10755, 7775, 2980
251895b99, 51, 12, 0, 1, 0, 1, 10775, 3895, 6880
1286926, 1, 9, 0, 1, 0, 1, 10795, 5595, 5200
28e8d9a, 2, 0, 0, 0, 0, 0, 0, 0, 0
252582522, 52, 3, 0, 1, 0, 1, 10795, 7055, 3740
125e2c31f, 25, 14, 0, 1, 0, 1, 10795, 9035, 1760
2ffd39116, ff, 9, 0, 1, 0, 1, 10815, 4695, 6120
4811e14, 4, 10, 0, 1, 0, 1, 10835, 8275, 2560
125937e3c, 25, 0, 0, 0, 0, 0, 0, 0, 0
34047b895, 40, 0, 0, 1, 0, 1, 10855, 4815, 6040
1ac4a49, 1, 8, 0, 1, 0, 1, 10895, 6015, 4880
45b4bb5, 4, 10, 0, 1, 0, 1, 10915, 4775, 6140
1452cc487, 45, 9, 0, 1, 0, 1, 10935, 4855, 6080
115ff4aab, 15, 6, 0, 1, 0, 1, 10955, 3695, 7260
1355edca4, 35, 3, 0, 1, 0, 1, 10955, 7375, 3580
2e6a86a, 2, 6, 0, 1, 0, 1, 10975, 6355, 4620
2ff70afe4, ff, 6, 0, 1, 0, 1, 10975, 8695, 2280
310e1ca6b, 10, 7, 0, 1, 0, 1, 10995, 6055, 4940
2c4f0de, 2, 12, 0, 1, 0, 1, 11035, 7575, 3460
497e0e6, 4, 15, 0, 1, 0, 1, 11035, 6635, 4400
33a48b9, 3, 3, 0, 1, 0, 1, 11055, 9775, 1280
11569469a, 15, 2, 0, 1, 0, 1, 11075, 8755, 2320
310679f3a, 10, 14, 0, 1, 0, 1, 11095, 8135, 2960
251200326, 51, 1, 0, 1, 0, 1, 11095, 4855, 6240
2545d3820, 54, 4, 0, 1, 0, 1, 11095, 3135, 7960
2537b1a3e, 53, 4, 0, 1, 0, 1, 11115, 7815, 3300
3107e979c, 10, 9, 0, 1, 0, 1, 11175, 5735, 5440
254b0b30a, 54, 8, 0, 1, 0, 1, 11175, 3455, 7720
1353b0a5a, 35, 13, 0, 1, 0, 1, 11175, 8275, 2900
252f18494, 52, 2, 0, 1, 0, 1, 11195, 8615, 2580
2536c2506, 53, 7, 0, 1, 0, 1, 11195, 5295, 5900
115dd0345, 15, 10, 0, 1, 0, 1, 11195, 8555, 2640
251200326, 51, 0, 0, 0, 0, 0, 0, 0, 0
2ff186c12, ff, 14, 0, 1, 0, 1, 11215, 9355, 1860
3e23027, 3, 1, 0, 1, 0, 1, 11235, 9335, 1900
3203d3023, 20, 7, 0, 1, 0, 1, 11235, 7495, 3740
1c92a00, 1, 2, 0, 1, 0, 1, 11255, 9055, 2200
34060baa9, 40, 15, 0, 1, 0, 1, 11255, 8075, 3180
135c0a592, 35, 8, 0, 1, 0, 1, 11275, 8735, 2540
320428ec5, 20, 3, 0, 1, 0, 1, 11295, 5935, 5360
254d9bec4, 54, 7, 0, 1, 0, 1, 11295, 3495, 7800
34075ef9f, 40, 6, 0, 1, 0, 1, 11335, 9275, 2060
2543f08dd, 54, 3, 0, 1, 0, 1, 11335, 6575, 4760
3cdd0f0, 3, 6, 0, 1, 0, 1, 11355, 5475, 5880
125478bff, 25, 4, 0, 1, 0, 1, 11355, 5415, 5940
25116c9c6, 51, 11, 0, 1, 0, 1, 11375, 8115, 3260
252f23743, 52, 7, 0, 1, 0, 1, 11375, 8135, 3240
33034a396, 30, 5, 0, 1, 0, 1, 11395, 9635, 1760
320428ec5, 20, 0, 0, 0, 0, 0, 0, 0, 0
254d9bec4, 54, 0, 0, 0, 0, 0, 0, 0, 0
1483b16, 1, 3, 0, 1, 0, 1, 11435, 7695, 3740
115d28861, 15, 8, 0, 1, 0, 1, 11435, 3135, 8300
135a2770c, 35, 13, 0, 1, 0, 1, 11435, 8415, 3020
25191f2d9, 51, 6, 0, 1, 0, 1, 11455, 9595, 1860
2ff0292ad, ff, 6, 0, 1, 0, 1, 11455, 9735, 1720
3105ac0fe, 10, 10, 0, 1, 0, 1, 11475, 4455, 7020
3204e09a5, 20, 15, 0, 1, 0, 1, 11475, 5195, 6280
3409894a4, 40, 15, 0, 1, 0, 1, 11495, 8235, 3260
135365c0c, 35, 11, 0, 1, 0, 1, 11495, 9875, 1620
3307fcfe7, 30, 3, 0, 1, 0, 1, 11515, 4015, 7500
275d434, 2, 15, 0, 1, 0, 1, 11555, 8395, 3160
252dcfb4c, 52, 12, 0, 1, 0, 1, 11555, 4855, 6700
148f2c4, 1, 6, 0, 1, 0, 1, 11575, 8835, 2740
340c346f9, 40, 5, 0, 1, 0, 1, 11575, 7835, 3740
1456603f5, 45, 5, 0, 1, 0, 1, 11575, 7095, 4480
320615868, 20, 10, 0, 1, 0, 1, 11595, 5515, 6080
3401ec2c5, 40, 10, 0, 1, 0, 1, 11615, 9075, 2540
115c7c281, 15, 14, 0, 1, 0, 1, 11635, 7675, 3960
115ebc971, 15, 2, 0, 1, 0, 1, 11675, 9375, 2300
145207099, 45, 2, 0, 1, 0, 1, 11695, 5775, 5920
1b01a09, 1, 2, 0, 1, 0, 1, 11715, 9515, 2200
3103a7cc2, 10, 11, 0, 1, 0, 1, 11755, 4275, 7480
2dc71d2, 2, 2, 0, 1, 0, 1, 11775, 9655, 2120
340da05b2, 40, 0, 0, 1, 0, 1, 11775, 6095, 5680
145e88db2, 45, 0, 0, 1, 0, 1, 11775, 1775, 10000
252dcfb4c, 52, 0, 0, 0, 0, 0, 0, 0, 0
1354113a9, 35, 5, 0, 1, 0, 1, 11795, 8555, 3240
2ff55e42c, ff, 3, 0, 1, 0, 1, 11815, 6895, 4920
216d4c4, 2, 0, 0, 1, 0, 1, 11835, 9775, 2060
310696ba8, 10, 9, 0, 1, 0, 1, 11855, 6495, 5360
11510f40a, 15, 15, 0, 1, 0, 1, 11875, 6955, 4920
2dc71d2, 2, 0, 0, 0, 0, 0, 0, 0, 0
2539c3694, 53, 4, 0, 1, 0, 1, 11895, 2895, 9000
254c0740e, 54, 8, 0, 1, 0, 1, 11895, 4495, 7400
13500b8e9, 35, 2, 0, 1, 0, 1, 11915, 6555, 5360
1452b2e4b, 45, 12, 0, 1, 0, 1, 11935, 6935, 5000
3971946, 3, 0, 0, 1, 0, 1, 11955, 8175, 3780
2535f41ae, 53, 8, 0, 1, 0, 1, 11995, 6335, 5660
1155ff1d4, 15, 11, 0, 1, 0, 1, 11995, 7155, 4840
254405401, 54, 9, 0, 1, 0, 1, 12015, 6335, 5680
11568342d, 15, 0, 0, 1, 0, 1, 12035, 7055, 4980
340c20227, 40, 4, 0, 1, 0, 1, 12055, 6375, 5680
1452fe1ec, 45, 2, 0, 1, 0, 1, 12055, 6075, 5980
3200ea858, 20, 10, 0, 1, 0, 1, 12075, 5815, 6260
310879013, 10, 3, 0, 1, 0, 1, 12115, 8175, 3940
115663a14, 15, 15, 0, 1, 0, 1, 12115, 7275, 4840
3b0ca01, 3, 15, 0, 1, 0, 1, 12135, 6795, 5340
125c8f2b8, 25, 0, 0, 1, 0, 1, 12135, 10095, 2040
1458d97d7, 45, 7, 0, 1, 0, 1, 12135, 4695, 7440
11589b9e0, 15, 6, 0, 1, 0, 1, 12155, 4415, 7740
13522a292, 35, 3, 0, 1, 0, 1, 12155, 7855, 4300
2ffe6972a, ff, 3, 0, 1, 0, 1, 12175, 7535, 4640
310879013, 10, 0, 0, 0, 0, 0, 0, 0, 0
1350b63c0, 35, 7, 0, 1, 0, 1, 12215, 3335, 8880
469a9e1, 4, 14, 0, 1, 0, 1, 12235, 8875, 3360
3b68912, 3, 14, 0, 1, 0, 1, 12255, 7835, 4420
251dd0c7b, 51, 4, 0, 1, 0, 1, 12255, 6535, 5720
1453b141c, 45, 7, 0, 1, 0, 1, 12255, 4855, 7400
252dcfb4c, 52, 0, 0, 0, 0, 0, 0, 0, 0
25413eada, 54, 0, 0, 1, 0, 1, 12295, 4655, 7640
1255bd695, 25, 15, 0, 1, 0, 1, 12295, 9515, 2780
10e1c66, 1, 8, 0, 1, 0, 1, 12335, 7615, 4720
1253b37c6, 25, 4, 0, 1, 0, 1, 12355, 7175, 5180
254d10b9f, 54, 5, 0, 1, 0, 1, 12375, 3495, 8880
1a6f001, 1, 11, 0, 1, 0, 1, 12395, 4755, 7640
1455bed95, 45, 5, 0, 1, 0, 1, 12415, 8415, 4000
17c31ec, 1, 8, 0, 1, 0, 1, 12435, 8095, 4340
135c54941, 35, 0, 0, 1, 0, 1, 12475, 8815, 3660
253de4ba9, 53, 8, 0, 1, 0, 1, 12495, 6495, 6000
1254018eb, 25, 10, 0, 1, 0, 1, 12495, 6915, 5580
145dc45a2, 45, 9, 0, 1, 0, 1, 12495, 7055, 5440
17c31ec, 1, 0, 0, 0, 0, 0, 0, 0, 0
252dcfb4c, 52, 0, 0, 0, 0, 0, 0, 0, 0
145bb9ad8, 45, 12, 0, 1, 0, 1, 12535, 7735, 4800
299f2a0, 2, 7, 0, 1, 0, 1, 12555, 7975, 4580
320db74c9, 20, 7, 0, 1, 0, 1, 12555, 9095, 3460
340c9bae5, 40, 5, 0, 1, 0, 1, 12555, 9175, 3380
252c15866, 52, 4, 0, 1, 0, 1, 12575, 4135, 8440
449b203, 4, 6, 0, 1, 0, 1, 12595, 9115, 3480
330c8ffc1, 30, 4, 0, 1, 0, 1, 12595, 9095, 3500
253905b56, 53, 7, 0, 1, 0, 1, 12595, 6535, 6060
2ffb977b9, ff, 4, 0, 1, 0, 1, 12615, 2355, 10260
1358e33e5, 35, 12, 0, 1, 0, 1, 12615, 8375, 4240
4abf4d7, 4, 0, 0, 1, 0, 1, 12635, 7695, 4940
340d8aea9, 40, 11, 0, 1, 0, 1, 12655, 9555, 3100
2b30e27, 2, 14, 0, 1, 0, 1, 12715, 5835, 6880
4304f20, 4, 7, 0, 1, 0, 1, 12715, 2575, 10140
310763acd, 10, 8, 0, 1, 0, 1, 12715, 8575, 4140
3302e5e1a, 30, 0, 0, 1, 0, 1, 12715, 9295, 3420
3202b5872, 20, 2, 0, 1, 0, 1, 12735, 9215, 3520
2513ebe8f, 51, 1, 0, 1, 0, 1, 12735, 6715, 6020
253af7a75, 53, 13, 0, 1, 0, 1, 12735, 8815, 3920
145b75590, 45, 8, 0, 1, 0, 1, 12735, 5115, 7620
4b65069, 4, 9, 0, 1, 0, 1, 12755, 8895, 3860
33076d9ed, 30, 9, 0, 1, 0, 1, 12775, 9535, 3240
2ff54183b, ff, 13, 0, 1, 0, 1, 12775, 8955, 3820
125aa57b4, 25, 11, 0, 1, 0, 1, 12795, 10035, 2760
3101d6e41, 10, 10, 0, 1, 0, 1, 12815, 6095, 6720
340910a8a, 40, 5, 0, 1, 0, 1, 12815, 9335, 3480
449b203, 4, 0, 0, 0, 0, 0, 0, 0, 0
34056a546, 40, 15, 0, 1, 0, 1, 12855, 9995, 2860
2ff1a4def, ff, 9, 0, 1, 0, 1, 12855, 7535, 5320
4a49332, 4, 0, 0, 1, 0, 1, 12875, 7855, 5020
310a0bb25, 10, 15, 0, 1, 0, 1, 12895, 5035, 7860
25372c72e, 53, 9, 0, 1, 0, 1, 12895, 9695, 3200
2ff384839, ff, 5, 0, 1, 0, 1, 12895, 8855, 4040
1252aee53, 25, 10, 0, 1, 0, 1, 12895, 7355, 5540
2cd9711, 2, 13, 0, 1, 0, 1, 12915, 7835, 5080
3e4973a, 3, 4, 0, 1, 0, 1, 12915, 9415, 3500
13560e06d, 35, 3, 0, 1, 0, 1, 12915, 8495, 4420
3101d6e41, 10, 0, 0, 0, 0, 0, 0, 0, 0
4086013, 4, 10, 0, 1, 0, 1, 12955, 6375, 6580
251d92b25, 51, 13, 0, 1, 0, 1, 12955, 6115, 6840
3206160af, 20, 12, 0, 1, 0, 1, 12975, 8215, 4760
1458f0fbb, 45, 6, 0, 1, 0, 1, 12975, 4275, 8700
404382e, 4, 1, 0, 1, 0, 1, 12995, 9475, 3520
330591d1c, 30, 10, 0, 1, 0, 1, 13015, 7855, 5160
14540452d, 45, 1, 0, 1, 0, 1, 13015, 6155, 6860
340d2c5b6, 40, 12, 0, 1, 0, 1, 13055, 5815, 7240
1bf0650, 1, 12, 0, 1, 0, 1, 13075, 9975, 3100
4086013, 4, 0, 0, 0, 0, 0, 0, 0, 0
3301d0fbc, 30, 1, 0, 1, 0, 1, 13075, 8895, 4180
145da3050, 45, 8, 0, 1, 0, 1, 13095, 5695, 7400
194ca3a, 1, 8, 0, 1, 0, 1, 13115, 9055, 4060
46056ae, 4, 1, 0, 1, 0, 1, 13115, 9635, 3480
252b6d670, 52, 12, 0, 1, 0, 1, 13115, 6135, 6980
251022d55, 51, 5, 0, 1, 0, 1, 13135, 9775, 3360
14540452d, 45, 0, 0, 0, 0, 0, 0, 0, 0
252157821, 52, 7, 0, 1, 0, 1, 13175, 9575, 3600
411daaa, 4, 11, 0, 1, 0, 1, 13195, 8595, 4600
12555e8f8, 25, 10, 0, 1, 0, 1, 13195, 7715, 5480
298b745, 2, 14, 0, 1, 0, 1, 13215, 6675, 6540
3b645c4, 3, 0, 0, 1, 0, 1, 13215, 9615, 3600
25268b419, 52, 3, 0, 1, 0, 1, 13215, 10095, 3120
145da3050, 45, 0, 0, 0, 0, 0, 0, 0, 0
46056ae, 4, 0, 0, 0, 0, 0, 0, 0, 0
2ffba4031, ff, 13, 0, 1, 0, 1, 13255, 9395, 3860
2cfa679, 2, 8, 0, 1, 0, 1, 13275, 9215, 4060
3b873bf, 3, 0, 0, 1, 0, 1, 13315, 9935, 3380
3106078e9, 10, 10, 0, 1, 0, 1, 13315, 6235, 7080
3301d0fbc, 30, 0, 0, 0, 0, 0, 0, 0, 0
135727ae6, 35, 3, 0, 1, 0, 1, 13315, 8815, 4500
115888da2, 15, 1, 0, 1, 0, 1, 13355, 9775, 3580
390abee, 3, 15, 0, 1, 0, 1, 13375, 9035, 4340
310e2c399, 10, 13, 0, 1, 0, 1, 13375, 8535, 4840
2544096bd, 54, 13, 0, 1, 0, 1, 13375, 9535, 3840
252d84259, 52, 7, 0, 1, 0, 1, 13395, 9895, 3500
251ea63d6, 51, 4, 0, 1, 0, 1, 13435, 8615, 4820
4fd728e, 4, 5, 0, 1, 0, 1, 13475, 6655, 6820
3307d884e, 30, 15, 0, 1, 0, 1, 13495, 8715, 4780
252dab3b3, 52, 6, 0, 1, 0, 1, 13495, 7675, 5820
2ff74f0f3, ff, 13, 0, 1, 0, 1, 13495, 9675, 3820
1a1ec85, 1, 8, 0, 1, 0, 1, 13515, 9695, 3820
2515a3511, 51, 0, 0, 1, 0, 1, 13535, 8655, 4880
4443803, 4, 11, 0, 1, 0, 1, 13555, 9395, 4160
145362d9a, 45, 7, 0, 1, 0, 1, 13575, 5895, 7680
1affd55, 1, 14, 0, 1, 0, 1, 13595, 6815, 6780
49190e1, 4, 0, 0, 1, 0, 1, 13595, 8335, 5260
2540b8b8e, 54, 2, 0, 1, 0, 1, 13615, 7255, 6360
135928818, 35, 12, 0, 1, 0, 1, 13615, 9015, 4600
2516a9a75, 51, 12, 0, 1, 0, 1, 13635, 5175, 8460
1250a2c57, 25, 8, 0, 1, 0, 1, 13635, 5855, 7780
1ba0bc8, 1, 11, 0, 1, 0, 1, 13675, 6675, 7000
3303d8573, 30, 3, 0, 1, 0, 1, 13675, 6735, 6940
1153c1d69, 15, 9, 0, 1, 0, 1, 13675, 4115, 9560
49190e1, 4, 0, 0, 0, 0, 0, 0, 0, 0
310a2157d, 10, 7, 0, 1, 0, 1, 13715, 9735, 3980
2ff676420, ff, 12, 0, 1, 0, 1, 13735, 8855, 4880
1ede585, 1, 13, 0, 1, 0, 1, 13795, 9255, 4540
115a980c9, 15, 11, 0, 1, 0, 1, 13795, 9715, 4080
12513b19b, 25, 9, 0, 1, 0, 1, 13815, 9055, 4760
34013607f, 40, 3, 0, 1, 0, 1, 13835, 5615, 8220
115165f4e, 15, 4, 0, 1, 0, 1, 13835, 8775, 5060
310b9b8f6, 10, 14, 0, 1, 0, 1, 13875, 7515, 6360
320590944, 20, 10, 0, 1, 0, 1, 13875, 7975, 5900
13528d365, 35, 1, 0, 1, 0, 1, 13895, 6575, 7320
14e775f, 1, 11, 0, 1, 0, 1, 13915, 6515, 7400
2dd273b, 2, 15, 0, 1, 0, 1, 13915, 7595, 6320
12513b19b, 25, 0, 0, 0, 0, 0, 0, 0, 0
2547f37e1, 54, 7, 0, 1, 0, 1, 13935, 6375, 7560
1150c9812, 15, 4, 0, 1, 0, 1, 13955, 8935, 5020
254c71c48, 54, 3, 0, 1, 0, 1, 13975, 9135, 4840
14e775f, 1, 0, 0, 0, 0, 0, 0, 0, 0
4173b46, 4, 10, 0, 1, 0, 1, 14035, 7495, 6540
3405e8494, 40, 4, 0, 1, 0, 1, 14035, 9895, 4140
252dc6ed8, 52, 3, 0, 1, 0, 1, 14035, 8975, 5060
145d68af7, 45, 1, 0, 1, 0, 1, 14035, 8595, 5440
4f8dfd0, 4, 7, 0, 1, 0, 1, 14075, 4535, 9540
3206bebd0, 20, 10, 0, 1, 0, 1, 14075, 9375, 4700
254936672, 54, 12, 0, 1, 0, 1, 14075, 9335, 4740
310defec7, 10, 11, 0, 1, 0, 1, 14095, 7955, 6140
330486464, 30, 12, 0, 1, 0, 1, 14095, 8535, 5560
252eeacb4, 52, 0, 0, 1, 0, 1, 14095, 6735, 7360
135188268, 35, 12, 0, 1, 0, 1, 14095, 9495, 4600
3401e1fe7, 40, 3, 0, 1, 0, 1, 14135, 6095, 8040
11517b7b2, 15, 8, 0, 1, 0, 1, 14155, 2975, 11180
3108eca32, 10, 15, 0, 1, 0, 1, 14175, 9195, 4980
1353606eb, 35, 3, 0, 1, 0, 1, 14175, 9615, 4560
33043eaa1, 30, 3, 0, 1, 0, 1, 14195, 8655, 5540
252eeacb4, 52, 0, 0, 0, 0, 0, 0, 0, 0
253212df0, 53, 7, 0, 1, 0, 1, 14195, 8295, 5900
1153b2e98, 15, 0, 0, 1, 0, 1, 14195, 9135, 5060
127f2f6, 1, 7, 0, 1, 0, 1, 14215, 10055, 4160
251762a0b, 51, 2, 0, 1, 0, 1, 14235, 7855, 6380
1352e9739, 35, 9, 0, 1, 0, 1, 14235, 9215, 5020
2ffb419bd, ff, 1, 0, 1, 0, 1, 14255, 9035, 5220
1153cff06, 15, 9, 0, 1, 0, 1, 14275, 5895, 8380
31096189a, 10, 15, 0, 1, 0, 1, 14295, 9835, 4460
135a21b0b, 35, 12, 0, 1, 0, 1, 14295, 9655, 4640
14e775f, 1, 0, 0, 0, 0, 0, 0, 0, 0
34023ef06, 40, 12, 0, 1, 0, 1, 14335, 6775, 7560
135830cce, 35, 3, 0, 1, 0, 1, 14375, 9935, 4440
1153cff06, 15, 0, 0, 0, 0, 0, 0, 0, 0
310712bc6, 10, 10, 0, 1, 0, 1, 14435, 7215, 7220
2511dfb2c, 51, 2, 0, 1, 0, 1, 14435, 8915, 5520
11592829f, 15, 5, 0, 1, 0, 1, 14435, 7695, 6740
135ac1f96, 35, 12, 0, 1, 0, 1, 14475, 10135, 4340
253bfb8a2, 53, 6, 0, 1, 0, 1, 14495, 6655, 7840
42d273e, 4, 9, 0, 1, 0, 1, 14515, 8275, 6240
12def6f, 1, 15, 0, 1, 0, 1, 14535, 7755, 6780
2512692e0, 51, 12, 0, 1, 0, 1, 14535, 7895, 6640
13556e6f9, 35, 8, 0, 1, 0, 1, 14535, 6815, 7720
254aeff91, 54, 8, 0, 1, 0, 1, 14555, 6975, 7580
11557afcc, 15, 0, 0, 1, 0, 1, 14555, 9455, 5100
46f23a9, 4, 8, 0, 1, 0, 1, 14635, 6655, 7980
31002c1a4, 10, 10, 0, 1, 0, 1, 14635, 9235, 5400
145ee1b31, 45, 7, 0, 1, 0, 1, 14635, 7015, 7620
2ff18fa35, ff, 4, 0, 1, 0, 1, 14675, 5895, 8780
252f69b30, 52, 0, 0, 1, 0, 1, 14695, 8975, 5720
13523fa36, 35, 1, 0, 1, 0, 1, 14695, 7735, 6960
3105f8c93, 10, 11, 0, 1, 0, 1, 14735, 8755, 5980
25455555f, 54, 8, 0, 1, 0, 1, 14755, 7135, 7620
178cc27, 1, 15, 0, 1, 0, 1, 14835, 8875, 5960
12539cabf, 25, 4, 0, 1, 0, 1, 14855, 10055, 4800
115a21e89, 15, 8, 0, 1, 0, 1, 14875, 6175, 8700
14534740e, 45, 1, 0, 1, 0, 1, 14875, 7875, 7000
4e2a671, 4, 7, 0, 1, 0, 1, 14975, 7335, 7640
14534740e, 45, 0, 0, 0, 0, 0, 0, 0, 0
4670a5b, 4, 7, 0, 1, 0, 1, 15055, 7175, 7880
145811a77, 45, 6, 0, 1, 0, 1, 15075, 6095, 8980
4e2a671, 4, 0, 0, 0, 0, 0, 0, 0, 0
1452c006b, 45, 4, 0, 1, 0, 1, 15115, 7335, 7780
42fff47, 4, 7, 0, 1, 0, 1, 15175, 7655, 7520
2ffbbdceb, ff, 7, 0, 1, 0, 1, 15195, 7815, 7380
49206df, 4, 8, 0, 1, 0, 1, 15215, 9535, 5680
1452c006b, 45, 0, 0, 0, 0, 0, 0, 0, 0
2ffb9273c, ff, 4, 0, 1, 0, 1, 15315, 3815, 11500
2541819ba, 54, 4, 0, 1, 0, 1, 15355, 9255, 6100
254001ec7, 54, 8, 0, 1, 0, 1, 15435, 7935, 7500
2ff389f9b, ff, 4, 0, 1, 0, 1, 15475, 9575, 5900
2ffb9273c, ff, 4, 0, 1, 0, 1, 15555, 3815, 11740
254862159, 54, 8, 0, 1, 0, 1, 15655, 8415, 7240
14509ce96, 45, 7, 0, 1, 0, 1, 15755, 8455, 7300
253a14d74, 53, 5, 0, 1, 0, 1, 15795, 7235, 8560
25476be68, 54, 7, 0, 1, 0, 1, 15855, 8615, 7240
2ff93c5da, ff, 7, 0, 1, 0, 1, 15955, 8775, 7180
2ff93c5da, ff, 7, 0, 1, 0, 1, 16055, 8775, 7280
2ff542812, ff, 8, 0, 1, 0, 1, 16155, 8895, 7260
2ff542812, ff, 8, 0, 1, 0, 1, 16255, 8895, 7360
1350a255c, 35, 7, 0, 1, 0, 1, 16395, 8935, 7460
2ff5c6737, ff, 7, 0, 1, 0, 1, 16455, 9255, 7200
2ffb2a4a5, ff, 6, 0, 1, 0, 1, 16555, 7075, 9480
145ea4b09, 45, 7, 0, 1, 0, 1, 16655, 9415, 7240
254a2e2eb, 54, 4, 0, 1, 0, 1, 16755, 4295, 12460
145d94f76, 45, 5, 0, 1, 0, 1, 16855, 6035, 10820
1355eb073, 35, 8, 0, 1, 0, 1, 17035, 10015, 7020
2ffa5d644, ff, 5, 0, 1, 0, 1, 17155, 8135, 9020
2ffa5d644, ff, 5, 0, 1, 0, 1, 17255, 8135, 9120
413774a, 4, 8, 0, 1, 0, 1, 17295, 10175, 7120
2ffce8252, ff, 4, 0, 1, 0, 1, 17355, 7495, 9860
254bc237a, 54, 0, 0, 1, 0, 1, 17455, 7535, 9920
2ffe0516a, ff, 4, 0, 1, 0, 1, 17555, 8295, 9260
254e007b3, 54, 0, 0, 1, 0, 1, 17655, 8495, 9160
145ab5af8, 45, 4, 0, 1, 0, 1, 17755, 9735, 8020
