Dato,Destino,Fuente,Reset,Valido,Overflow,Completado,Escritura,Lectura,Latencia
145000007, 45, 7, 0, 1, 0, 1, 335, 115, 220
145000003, 45, 3, 0, 1, 0, 1, 375, 135, 240
145000007, 45, 7, 0, 1, 0, 1, 455, 235, 220
145000006, 45, 6, 0, 1, 0, 1, 495, 115, 380
145000007, 45, 7, 0, 1, 0, 1, 575, 335, 240
145000005, 45, 5, 0, 1, 0, 1, 615, 115, 500
145000007, 45, 7, 0, 1, 0, 1, 695, 435, 260
145000006, 45, 6, 0, 1, 0, 1, 735, 235, 500
145000007, 45, 7, 0, 1, 0, 1, 815, 535, 280
145000006, 45, 6, 0, 1, 0, 1, 855, 335, 520
145000007, 45, 7, 0, 1, 0, 1, 935, 635, 300
145000002, 45, 2, 0, 1, 0, 1, 975, 135, 840
245000004, 45, 4, 0, 0, 1, 0, 0, 0, 0
145000007, 45, 7, 0, 1, 0, 1, 1055, 735, 320
145000006, 45, 6, 0, 1, 0, 1, 1095, 435, 660
245000003, 45, 3, 0, 0, 1, 0, 0, 0, 0
245000005, 45, 5, 0, 0, 1, 0, 0, 0, 0
145000007, 45, 7, 0, 1, 0, 1, 1175, 835, 340
145000006, 45, 6, 0, 1, 0, 1, 1215, 535, 680
245000005, 45, 5, 0, 0, 1, 0, 0, 0, 0
145000007, 45, 7, 0, 1, 0, 1, 1295, 935, 360
145000003, 45, 3, 0, 1, 0, 1, 1335, 375, 960
245000003, 45, 3, 0, 0, 1, 0, 0, 0, 0
245000005, 45, 5, 0, 0, 1, 0, 0, 0, 0
145000007, 45, 7, 0, 1, 0, 1, 1415, 1035, 380
145000006, 45, 6, 0, 1, 0, 1, 1455, 635, 820
245000005, 45, 5, 0, 0, 1, 0, 0, 0, 0
145000007, 45, 7, 0, 1, 0, 1, 1535, 1135, 400
145000004, 45, 4, 0, 1, 0, 1, 1575, 235, 1340
245000002, 45, 2, 0, 0, 1, 0, 0, 0, 0
145000007, 45, 7, 0, 1, 0, 1, 1655, 1235, 420
145000006, 45, 6, 0, 1, 0, 1, 1695, 735, 960
245000001, 45, 1, 0, 0, 1, 0, 0, 0, 0
245000005, 45, 5, 0, 0, 1, 0, 0, 0, 0
145000007, 45, 7, 0, 1, 0, 1, 1775, 1335, 440
145000006, 45, 6, 0, 1, 0, 1, 1815, 835, 980
245000005, 45, 5, 0, 0, 1, 0, 0, 0, 0
145000007, 45, 7, 0, 1, 0, 1, 1895, 1435, 460
145000005, 45, 5, 0, 1, 0, 1, 1935, 835, 1100
245000004, 45, 4, 0, 0, 1, 0, 0, 0, 0
245000005, 45, 5, 0, 0, 1, 0, 0, 0, 0
145000007, 45, 7, 0, 1, 0, 1, 2015, 1535, 480
145000006, 45, 6, 0, 1, 0, 1, 2055, 935, 1120
245000005, 45, 5, 0, 0, 1, 0, 0, 0, 0
145000007, 45, 7, 0, 1, 0, 1, 2135, 1635, 500
145000002, 45, 2, 0, 1, 0, 1, 2175, 515, 1660
245000000, 45, 0, 0, 0, 1, 0, 0, 0, 0
145000007, 45, 7, 0, 1, 0, 1, 2255, 1735, 520
145000006, 45, 6, 0, 1, 0, 1, 2295, 1035, 1260
245000001, 45, 1, 0, 0, 1, 0, 0, 0, 0
245000005, 45, 5, 0, 0, 1, 0, 0, 0, 0
145000007, 45, 7, 0, 1, 0, 1, 2375, 1835, 540
145000006, 45, 6, 0, 1, 0, 1, 2415, 1135, 1280
245000005, 45, 5, 0, 0, 1, 0, 0, 0, 0
145000007, 45, 7, 0, 1, 0, 1, 2495, 1935, 560
145000005, 45, 5, 0, 1, 0, 1, 2535, 1335, 1200
245000000, 45, 0, 0, 0, 1, 0, 0, 0, 0
245000005, 45, 5, 0, 0, 1, 0, 0, 0, 0
145000007, 45, 7, 0, 1, 0, 1, 2615, 2035, 580
145000006, 45, 6, 0, 1, 0, 1, 2655, 1235, 1420
245000005, 45, 5, 0, 0, 1, 0, 0, 0, 0
145000007, 45, 7, 0, 1, 0, 1, 2735, 2135, 600
145000000, 45, 0, 0, 1, 0, 1, 2775, 395, 2380
245000004, 45, 4, 0, 0, 1, 0, 0, 0, 0
145000007, 45, 7, 0, 1, 0, 1, 2855, 2235, 620
145000006, 45, 6, 0, 1, 0, 1, 2895, 1335, 1560
245000004, 45, 4, 0, 0, 1, 0, 0, 0, 0
245000005, 45, 5, 0, 0, 1, 0, 0, 0, 0
145000007, 45, 7, 0, 1, 0, 1, 2975, 2335, 640
145000006, 45, 6, 0, 1, 0, 1, 3015, 1435, 1580
245000005, 45, 5, 0, 0, 1, 0, 0, 0, 0
145000007, 45, 7, 0, 1, 0, 1, 3095, 2435, 660
145000005, 45, 5, 0, 1, 0, 1, 3135, 1835, 1300
245000004, 45, 4, 0, 0, 1, 0, 0, 0, 0
245000005, 45, 5, 0, 0, 1, 0, 0, 0, 0
145000007, 45, 7, 0, 1, 0, 1, 3215, 2535, 680
145000006, 45, 6, 0, 1, 0, 1, 3255, 1535, 1720
245000005, 45, 5, 0, 0, 1, 0, 0, 0, 0
145000007, 45, 7, 0, 1, 0, 1, 3335, 2635, 700
145000004, 45, 4, 0, 1, 0, 1, 3375, 835, 2540
245000004, 45, 4, 0, 0, 1, 0, 0, 0, 0
145000007, 45, 7, 0, 1, 0, 1, 3455, 2735, 720
145000006, 45, 6, 0, 1, 0, 1, 3495, 1635, 1860
245000004, 45, 4, 0, 0, 1, 0, 0, 0, 0
245000005, 45, 5, 0, 0, 1, 0, 0, 0, 0
145000007, 45, 7, 0, 1, 0, 1, 3575, 2835, 740
145000006, 45, 6, 0, 1, 0, 1, 3615, 1735, 1880
245000005, 45, 5, 0, 0, 1, 0, 0, 0, 0
145000007, 45, 7, 0, 1, 0, 1, 3695, 2935, 760
145000005, 45, 5, 0, 1, 0, 1, 3735, 2335, 1400
245000004, 45, 4, 0, 0, 1, 0, 0, 0, 0
245000005, 45, 5, 0, 0, 1, 0, 0, 0, 0
145000007, 45, 7, 0, 1, 0, 1, 3815, 3035, 780
145000006, 45, 6, 0, 1, 0, 1, 3855, 1835, 2020
245000005, 45, 5, 0, 0, 1, 0, 0, 0, 0
145000007, 45, 7, 0, 1, 0, 1, 3935, 3135, 800
145000004, 45, 4, 0, 1, 0, 1, 3975, 1315, 2660
245000004, 45, 4, 0, 0, 1, 0, 0, 0, 0
145000007, 45, 7, 0, 1, 0, 1, 4055, 3235, 820
145000006, 45, 6, 0, 1, 0, 1, 4095, 1935, 2160
245000004, 45, 4, 0, 0, 1, 0, 0, 0, 0
245000005, 45, 5, 0, 0, 1, 0, 0, 0, 0
145000007, 45, 7, 0, 1, 0, 1, 4175, 3335, 840
145000006, 45, 6, 0, 1, 0, 1, 4215, 2035, 2180
245000005, 45, 5, 0, 0, 1, 0, 0, 0, 0
145000007, 45, 7, 0, 1, 0, 1, 4295, 3435, 860
145000005, 45, 5, 0, 1, 0, 1, 4335, 2835, 1500
245000004, 45, 4, 0, 0, 1, 0, 0, 0, 0
245000005, 45, 5, 0, 0, 1, 0, 0, 0, 0
145000007, 45, 7, 0, 1, 0, 1, 4415, 3535, 880
145000006, 45, 6, 0, 1, 0, 1, 4455, 2135, 2320
245000005, 45, 5, 0, 0, 1, 0, 0, 0, 0
145000007, 45, 7, 0, 1, 0, 1, 4535, 3635, 900
145000004, 45, 4, 0, 1, 0, 1, 4575, 1795, 2780
245000004, 45, 4, 0, 0, 1, 0, 0, 0, 0
145000007, 45, 7, 0, 1, 0, 1, 4655, 3735, 920
145000006, 45, 6, 0, 1, 0, 1, 4695, 2235, 2460
245000004, 45, 4, 0, 0, 1, 0, 0, 0, 0
245000005, 45, 5, 0, 0, 1, 0, 0, 0, 0
145000007, 45, 7, 0, 1, 0, 1, 4775, 3835, 940
145000006, 45, 6, 0, 1, 0, 1, 4815, 2335, 2480
245000005, 45, 5, 0, 0, 1, 0, 0, 0, 0
145000007, 45, 7, 0, 1, 0, 1, 4895, 3935, 960
145000005, 45, 5, 0, 1, 0, 1, 4935, 3335, 1600
245000004, 45, 4, 0, 0, 1, 0, 0, 0, 0
245000005, 45, 5, 0, 0, 1, 0, 0, 0, 0
145000007, 45, 7, 0, 1, 0, 1, 5015, 4035, 980
145000006, 45, 6, 0, 1, 0, 1, 5055, 2435, 2620
245000005, 45, 5, 0, 0, 1, 0, 0, 0, 0
145000007, 45, 7, 0, 1, 0, 1, 5135, 4135, 1000
145000004, 45, 4, 0, 1, 0, 1, 5175, 2275, 2900
245000004, 45, 4, 0, 0, 1, 0, 0, 0, 0
145000007, 45, 7, 0, 1, 0, 1, 5255, 4235, 1020
145000006, 45, 6, 0, 1, 0, 1, 5295, 2535, 2760
245000004, 45, 4, 0, 0, 1, 0, 0, 0, 0
245000005, 45, 5, 0, 0, 1, 0, 0, 0, 0
145000007, 45, 7, 0, 1, 0, 1, 5375, 4335, 1040
145000006, 45, 6, 0, 1, 0, 1, 5415, 2635, 2780
245000005, 45, 5, 0, 0, 1, 0, 0, 0, 0
145000007, 45, 7, 0, 1, 0, 1, 5495, 4435, 1060
145000005, 45, 5, 0, 1, 0, 1, 5535, 3835, 1700
245000004, 45, 4, 0, 0, 1, 0, 0, 0, 0
245000005, 45, 5, 0, 0, 1, 0, 0, 0, 0
145000007, 45, 7, 0, 1, 0, 1, 5615, 4535, 1080
145000006, 45, 6, 0, 1, 0, 1, 5655, 2735, 2920
245000005, 45, 5, 0, 0, 1, 0, 0, 0, 0
145000007, 45, 7, 0, 1, 0, 1, 5735, 4635, 1100
145000004, 45, 4, 0, 1, 0, 1, 5775, 2755, 3020
245000004, 45, 4, 0, 0, 1, 0, 0, 0, 0
145000007, 45, 7, 0, 1, 0, 1, 5855, 4735, 1120
145000006, 45, 6, 0, 1, 0, 1, 5895, 2835, 3060
245000004, 45, 4, 0, 0, 1, 0, 0, 0, 0
245000005, 45, 5, 0, 0, 1, 0, 0, 0, 0
145000007, 45, 7, 0, 1, 0, 1, 5975, 4835, 1140
145000006, 45, 6, 0, 1, 0, 1, 6015, 2935, 3080
245000005, 45, 5, 0, 0, 1, 0, 0, 0, 0
145000007, 45, 7, 0, 1, 0, 1, 6095, 4935, 1160
145000005, 45, 5, 0, 1, 0, 1, 6135, 4335, 1800
245000004, 45, 4, 0, 0, 1, 0, 0, 0, 0
245000005, 45, 5, 0, 0, 1, 0, 0, 0, 0
145000007, 45, 7, 0, 1, 0, 1, 6215, 5035, 1180
145000006, 45, 6, 0, 1, 0, 1, 6255, 3035, 3220
245000005, 45, 5, 0, 0, 1, 0, 0, 0, 0
145000007, 45, 7, 0, 1, 0, 1, 6335, 5135, 1200
145000004, 45, 4, 0, 1, 0, 1, 6375, 3235, 3140
245000004, 45, 4, 0, 0, 1, 0, 0, 0, 0
145000007, 45, 7, 0, 1, 0, 1, 6455, 5235, 1220
145000006, 45, 6, 0, 1, 0, 1, 6495, 3135, 3360
245000004, 45, 4, 0, 0, 1, 0, 0, 0, 0
245000005, 45, 5, 0, 0, 1, 0, 0, 0, 0
145000007, 45, 7, 0, 1, 0, 1, 6575, 5335, 1240
145000006, 45, 6, 0, 1, 0, 1, 6615, 3235, 3380
245000005, 45, 5, 0, 0, 1, 0, 0, 0, 0
145000007, 45, 7, 0, 1, 0, 1, 6695, 5435, 1260
145000005, 45, 5, 0, 1, 0, 1, 6735, 4835, 1900
245000004, 45, 4, 0, 0, 1, 0, 0, 0, 0
245000005, 45, 5, 0, 0, 1, 0, 0, 0, 0
145000007, 45, 7, 0, 1, 0, 1, 6815, 5535, 1280
145000006, 45, 6, 0, 1, 0, 1, 6855, 3335, 3520
245000005, 45, 5, 0, 0, 1, 0, 0, 0, 0
145000007, 45, 7, 0, 1, 0, 1, 6935, 5635, 1300
145000004, 45, 4, 0, 1, 0, 1, 6975, 3715, 3260
245000004, 45, 4, 0, 0, 1, 0, 0, 0, 0
145000007, 45, 7, 0, 1, 0, 1, 7055, 5735, 1320
145000006, 45, 6, 0, 1, 0, 1, 7095, 3435, 3660
245000004, 45, 4, 0, 0, 1, 0, 0, 0, 0
245000005, 45, 5, 0, 0, 1, 0, 0, 0, 0
145000007, 45, 7, 0, 1, 0, 1, 7175, 5835, 1340
145000006, 45, 6, 0, 1, 0, 1, 7215, 3535, 3680
245000005, 45, 5, 0, 0, 1, 0, 0, 0, 0
145000007, 45, 7, 0, 1, 0, 1, 7295, 5935, 1360
145000005, 45, 5, 0, 1, 0, 1, 7335, 5335, 2000
245000004, 45, 4, 0, 0, 1, 0, 0, 0, 0
245000005, 45, 5, 0, 0, 1, 0, 0, 0, 0
145000007, 45, 7, 0, 1, 0, 1, 7415, 6035, 1380
145000006, 45, 6, 0, 1, 0, 1, 7455, 3635, 3820
245000005, 45, 5, 0, 0, 1, 0, 0, 0, 0
145000007, 45, 7, 0, 1, 0, 1, 7535, 6135, 1400
145000004, 45, 4, 0, 1, 0, 1, 7575, 4195, 3380
245000004, 45, 4, 0, 0, 1, 0, 0, 0, 0
145000007, 45, 7, 0, 1, 0, 1, 7655, 6235, 1420
145000006, 45, 6, 0, 1, 0, 1, 7695, 3735, 3960
245000004, 45, 4, 0, 0, 1, 0, 0, 0, 0
245000005, 45, 5, 0, 0, 1, 0, 0, 0, 0
145000007, 45, 7, 0, 1, 0, 1, 7775, 6335, 1440
145000006, 45, 6, 0, 1, 0, 1, 7815, 3835, 3980
245000005, 45, 5, 0, 0, 1, 0, 0, 0, 0
145000007, 45, 7, 0, 1, 0, 1, 7895, 6435, 1460
145000005, 45, 5, 0, 1, 0, 1, 7935, 5835, 2100
245000004, 45, 4, 0, 0, 1, 0, 0, 0, 0
245000005, 45, 5, 0, 0, 1, 0, 0, 0, 0
145000007, 45, 7, 0, 1, 0, 1, 8015, 6535, 1480
145000006, 45, 6, 0, 1, 0, 1, 8055, 3935, 4120
245000005, 45, 5, 0, 0, 1, 0, 0, 0, 0
145000007, 45, 7, 0, 1, 0, 1, 8135, 6635, 1500
145000004, 45, 4, 0, 1, 0, 1, 8175, 4675, 3500
245000004, 45, 4, 0, 0, 1, 0, 0, 0, 0
145000007, 45, 7, 0, 1, 0, 1, 8255, 6735, 1520
145000006, 45, 6, 0, 1, 0, 1, 8295, 4035, 4260
245000004, 45, 4, 0, 0, 1, 0, 0, 0, 0
245000005, 45, 5, 0, 0, 1, 0, 0, 0, 0
145000007, 45, 7, 0, 1, 0, 1, 8375, 6835, 1540
145000006, 45, 6, 0, 1, 0, 1, 8415, 4135, 4280
245000005, 45, 5, 0, 0, 1, 0, 0, 0, 0
145000007, 45, 7, 0, 1, 0, 1, 8495, 6935, 1560
145000005, 45, 5, 0, 1, 0, 1, 8535, 6335, 2200
245000004, 45, 4, 0, 0, 1, 0, 0, 0, 0
245000005, 45, 5, 0, 0, 1, 0, 0, 0, 0
145000007, 45, 7, 0, 1, 0, 1, 8615, 7035, 1580
145000006, 45, 6, 0, 1, 0, 1, 8655, 4235, 4420
245000005, 45, 5, 0, 0, 1, 0, 0, 0, 0
145000007, 45, 7, 0, 1, 0, 1, 8735, 7135, 1600
145000004, 45, 4, 0, 1, 0, 1, 8775, 5155, 3620
245000004, 45, 4, 0, 0, 1, 0, 0, 0, 0
145000007, 45, 7, 0, 1, 0, 1, 8855, 7235, 1620
145000006, 45, 6, 0, 1, 0, 1, 8895, 4335, 4560
245000004, 45, 4, 0, 0, 1, 0, 0, 0, 0
245000005, 45, 5, 0, 0, 1, 0, 0, 0, 0
145000007, 45, 7, 0, 1, 0, 1, 8975, 7335, 1640
145000006, 45, 6, 0, 1, 0, 1, 9015, 4435, 4580
245000005, 45, 5, 0, 0, 1, 0, 0, 0, 0
145000007, 45, 7, 0, 1, 0, 1, 9095, 7435, 1660
145000005, 45, 5, 0, 1, 0, 1, 9135, 6835, 2300
245000004, 45, 4, 0, 0, 1, 0, 0, 0, 0
245000005, 45, 5, 0, 0, 1, 0, 0, 0, 0
145000007, 45, 7, 0, 1, 0, 1, 9215, 7535, 1680
145000006, 45, 6, 0, 1, 0, 1, 9255, 4535, 4720
245000005, 45, 5, 0, 0, 1, 0, 0, 0, 0
145000007, 45, 7, 0, 1, 0, 1, 9335, 7635, 1700
145000004, 45, 4, 0, 1, 0, 1, 9375, 5635, 3740
245000004, 45, 4, 0, 0, 1, 0, 0, 0, 0
145000007, 45, 7, 0, 1, 0, 1, 9455, 7735, 1720
145000006, 45, 6, 0, 1, 0, 1, 9495, 4635, 4860
245000004, 45, 4, 0, 0, 1, 0, 0, 0, 0
245000005, 45, 5, 0, 0, 1, 0, 0, 0, 0
145000007, 45, 7, 0, 1, 0, 1, 9575, 7835, 1740
145000006, 45, 6, 0, 1, 0, 1, 9615, 4735, 4880
245000005, 45, 5, 0, 0, 1, 0, 0, 0, 0
145000007, 45, 7, 0, 1, 0, 1, 9695, 7935, 1760
145000005, 45, 5, 0, 1, 0, 1, 9735, 7335, 2400
245000004, 45, 4, 0, 0, 1, 0, 0, 0, 0
245000005, 45, 5, 0, 0, 1, 0, 0, 0, 0
145000007, 45, 7, 0, 1, 0, 1, 9815, 8035, 1780
145000006, 45, 6, 0, 1, 0, 1, 9855, 4835, 5020
245000005, 45, 5, 0, 0, 1, 0, 0, 0, 0
145000007, 45, 7, 0, 1, 0, 1, 9935, 8135, 1800
145000004, 45, 4, 0, 1, 0, 1, 9975, 6115, 3860
245000004, 45, 4, 0, 0, 1, 0, 0, 0, 0
145000007, 45, 7, 0, 1, 0, 1, 10055, 8235, 1820
145000006, 45, 6, 0, 1, 0, 1, 10095, 4935, 5160
245000004, 45, 4, 0, 0, 1, 0, 0, 0, 0
245000005, 45, 5, 0, 0, 1, 0, 0, 0, 0
145000007, 45, 7, 0, 1, 0, 1, 10175, 8335, 1840
145000006, 45, 6, 0, 1, 0, 1, 10215, 5035, 5180
245000005, 45, 5, 0, 0, 1, 0, 0, 0, 0
145000007, 45, 7, 0, 1, 0, 1, 10295, 8435, 1860
145000005, 45, 5, 0, 1, 0, 1, 10335, 7835, 2500
245000004, 45, 4, 0, 0, 1, 0, 0, 0, 0
245000005, 45, 5, 0, 0, 1, 0, 0, 0, 0
145000007, 45, 7, 0, 1, 0, 1, 10415, 8535, 1880
145000006, 45, 6, 0, 1, 0, 1, 10455, 5135, 5320
245000005, 45, 5, 0, 0, 1, 0, 0, 0, 0
145000007, 45, 7, 0, 1, 0, 1, 10535, 8635, 1900
145000004, 45, 4, 0, 1, 0, 1, 10575, 6595, 3980
245000004, 45, 4, 0, 0, 1, 0, 0, 0, 0
145000007, 45, 7, 0, 1, 0, 1, 10655, 8735, 1920
145000006, 45, 6, 0, 1, 0, 1, 10695, 5235, 5460
245000004, 45, 4, 0, 0, 1, 0, 0, 0, 0
245000005, 45, 5, 0, 0, 1, 0, 0, 0, 0
145000007, 45, 7, 0, 1, 0, 1, 10775, 8835, 1940
145000006, 45, 6, 0, 1, 0, 1, 10815, 5335, 5480
245000005, 45, 5, 0, 0, 1, 0, 0, 0, 0
145000007, 45, 7, 0, 1, 0, 1, 10895, 8935, 1960
145000005, 45, 5, 0, 1, 0, 1, 10935, 8335, 2600
245000004, 45, 4, 0, 0, 1, 0, 0, 0, 0
245000005, 45, 5, 0, 0, 1, 0, 0, 0, 0
145000007, 45, 7, 0, 1, 0, 1, 11015, 9035, 1980
145000006, 45, 6, 0, 1, 0, 1, 11055, 5435, 5620
245000005, 45, 5, 0, 0, 1, 0, 0, 0, 0
145000007, 45, 7, 0, 1, 0, 1, 11135, 9135, 2000
145000004, 45, 4, 0, 1, 0, 1, 11175, 7075, 4100
245000004, 45, 4, 0, 0, 1, 0, 0, 0, 0
145000007, 45, 7, 0, 1, 0, 1, 11255, 9235, 2020
145000006, 45, 6, 0, 1, 0, 1, 11295, 5535, 5760
245000004, 45, 4, 0, 0, 1, 0, 0, 0, 0
245000005, 45, 5, 0, 0, 1, 0, 0, 0, 0
145000007, 45, 7, 0, 1, 0, 1, 11375, 9335, 2040
145000006, 45, 6, 0, 1, 0, 1, 11415, 5635, 5780
245000005, 45, 5, 0, 0, 1, 0, 0, 0, 0
145000007, 45, 7, 0, 1, 0, 1, 11495, 9435, 2060
145000005, 45, 5, 0, 1, 0, 1, 11535, 8835, 2700
245000004, 45, 4, 0, 0, 1, 0, 0, 0, 0
245000005, 45, 5, 0, 0, 1, 0, 0, 0, 0
145000007, 45, 7, 0, 1, 0, 1, 11615, 9535, 2080
145000006, 45, 6, 0, 1, 0, 1, 11655, 5735, 5920
245000005, 45, 5, 0, 0, 1, 0, 0, 0, 0
145000007, 45, 7, 0, 1, 0, 1, 11735, 9635, 2100
145000004, 45, 4, 0, 1, 0, 1, 11775, 7555, 4220
245000004, 45, 4, 0, 0, 1, 0, 0, 0, 0
145000007, 45, 7, 0, 1, 0, 1, 11855, 9735, 2120
145000006, 45, 6, 0, 1, 0, 1, 11895, 5835, 6060
245000004, 45, 4, 0, 0, 1, 0, 0, 0, 0
245000005, 45, 5, 0, 0, 1, 0, 0, 0, 0
145000007, 45, 7, 0, 1, 0, 1, 11975, 9835, 2140
145000006, 45, 6, 0, 1, 0, 1, 12015, 5935, 6080
245000005, 45, 5, 0, 0, 1, 0, 0, 0, 0
145000007, 45, 7, 0, 1, 0, 1, 12095, 9935, 2160
145000005, 45, 5, 0, 1, 0, 1, 12135, 9335, 2800
245000004, 45, 4, 0, 0, 1, 0, 0, 0, 0
245000005, 45, 5, 0, 0, 1, 0, 0, 0, 0
145000007, 45, 7, 0, 1, 0, 1, 12215, 10035, 2180
145000006, 45, 6, 0, 1, 0, 1, 12255, 6035, 6220
245000005, 45, 5, 0, 0, 1, 0, 0, 0, 0
145000007, 45, 7, 0, 1, 0, 1, 12335, 10135, 2200
145000004, 45, 4, 0, 1, 0, 1, 12375, 8035, 4340
245000004, 45, 4, 0, 0, 1, 0, 0, 0, 0
145000007, 45, 7, 0, 1, 0, 1, 12455, 10235, 2220
145000006, 45, 6, 0, 1, 0, 1, 12495, 6135, 6360
245000004, 45, 4, 0, 0, 1, 0, 0, 0, 0
245000005, 45, 5, 0, 0, 1, 0, 0, 0, 0
145000007, 45, 7, 0, 1, 0, 1, 12575, 10335, 2240
145000006, 45, 6, 0, 1, 0, 1, 12615, 6235, 6380
245000005, 45, 5, 0, 0, 1, 0, 0, 0, 0
145000007, 45, 7, 0, 1, 0, 1, 12695, 10435, 2260
145000005, 45, 5, 0, 1, 0, 1, 12735, 9835, 2900
245000004, 45, 4, 0, 0, 1, 0, 0, 0, 0
245000005, 45, 5, 0, 0, 1, 0, 0, 0, 0
145000007, 45, 7, 0, 1, 0, 1, 12815, 10535, 2280
145000006, 45, 6, 0, 1, 0, 1, 12855, 6335, 6520
245000005, 45, 5, 0, 0, 1, 0, 0, 0, 0
145000007, 45, 7, 0, 1, 0, 1, 12935, 10635, 2300
145000004, 45, 4, 0, 1, 0, 1, 12975, 8515, 4460
245000004, 45, 4, 0, 0, 1, 0, 0, 0, 0
145000007, 45, 7, 0, 1, 0, 1, 13055, 10735, 2320
145000006, 45, 6, 0, 1, 0, 1, 13095, 6435, 6660
245000004, 45, 4, 0, 0, 1, 0, 0, 0, 0
245000005, 45, 5, 0, 0, 1, 0, 0, 0, 0
145000007, 45, 7, 0, 1, 0, 1, 13175, 10835, 2340
145000006, 45, 6, 0, 1, 0, 1, 13215, 6535, 6680
245000005, 45, 5, 0, 0, 1, 0, 0, 0, 0
145000007, 45, 7, 0, 1, 0, 1, 13295, 10935, 2360
145000005, 45, 5, 0, 1, 0, 1, 13335, 10335, 3000
245000004, 45, 4, 0, 0, 1, 0, 0, 0, 0
245000005, 45, 5, 0, 0, 1, 0, 0, 0, 0
145000007, 45, 7, 0, 1, 0, 1, 13415, 11035, 2380
145000006, 45, 6, 0, 1, 0, 1, 13455, 6635, 6820
245000005, 45, 5, 0, 0, 1, 0, 0, 0, 0
145000007, 45, 7, 0, 1, 0, 1, 13535, 11135, 2400
145000004, 45, 4, 0, 1, 0, 1, 13575, 8995, 4580
245000004, 45, 4, 0, 0, 1, 0, 0, 0, 0
145000007, 45, 7, 0, 1, 0, 1, 13655, 11235, 2420
145000006, 45, 6, 0, 1, 0, 1, 13695, 6735, 6960
245000004, 45, 4, 0, 0, 1, 0, 0, 0, 0
245000005, 45, 5, 0, 0, 1, 0, 0, 0, 0
145000007, 45, 7, 0, 1, 0, 1, 13775, 11335, 2440
145000006, 45, 6, 0, 1, 0, 1, 13815, 6835, 6980
245000005, 45, 5, 0, 0, 1, 0, 0, 0, 0
145000007, 45, 7, 0, 1, 0, 1, 13895, 11435, 2460
145000005, 45, 5, 0, 1, 0, 1, 13935, 10835, 3100
245000004, 45, 4, 0, 0, 1, 0, 0, 0, 0
245000005, 45, 5, 0, 0, 1, 0, 0, 0, 0
145000007, 45, 7, 0, 1, 0, 1, 14015, 11535, 2480
145000006, 45, 6, 0, 1, 0, 1, 14055, 6935, 7120
245000005, 45, 5, 0, 0, 1, 0, 0, 0, 0
145000007, 45, 7, 0, 1, 0, 1, 14135, 11635, 2500
145000004, 45, 4, 0, 1, 0, 1, 14175, 9475, 4700
245000004, 45, 4, 0, 0, 1, 0, 0, 0, 0
145000007, 45, 7, 0, 1, 0, 1, 14255, 11735, 2520
145000006, 45, 6, 0, 1, 0, 1, 14295, 7035, 7260
245000004, 45, 4, 0, 0, 1, 0, 0, 0, 0
245000005, 45, 5, 0, 0, 1, 0, 0, 0, 0
145000007, 45, 7, 0, 1, 0, 1, 14375, 11835, 2540
145000006, 45, 6, 0, 1, 0, 1, 14415, 7135, 7280
245000005, 45, 5, 0, 0, 1, 0, 0, 0, 0
145000007, 45, 7, 0, 1, 0, 1, 14495, 11935, 2560
145000005, 45, 5, 0, 1, 0, 1, 14535, 11335, 3200
245000004, 45, 4, 0, 0, 1, 0, 0, 0, 0
245000005, 45, 5, 0, 0, 1, 0, 0, 0, 0
145000007, 45, 7, 0, 1, 0, 1, 14615, 12035, 2580
145000006, 45, 6, 0, 1, 0, 1, 14655, 7235, 7420
245000005, 45, 5, 0, 0, 1, 0, 0, 0, 0
145000007, 45, 7, 0, 1, 0, 1, 14735, 12135, 2600
145000004, 45, 4, 0, 1, 0, 1, 14775, 9955, 4820
245000004, 45, 4, 0, 0, 1, 0, 0, 0, 0
145000007, 45, 7, 0, 1, 0, 1, 14855, 12235, 2620
145000006, 45, 6, 0, 1, 0, 1, 14895, 7335, 7560
245000004, 45, 4, 0, 0, 1, 0, 0, 0, 0
245000005, 45, 5, 0, 0, 1, 0, 0, 0, 0
145000007, 45, 7, 0, 1, 0, 1, 14975, 12335, 2640
145000006, 45, 6, 0, 1, 0, 1, 15015, 7435, 7580
245000005, 45, 5, 0, 0, 1, 0, 0, 0, 0
145000007, 45, 7, 0, 1, 0, 1, 15095, 12435, 2660
145000005, 45, 5, 0, 1, 0, 1, 15135, 11835, 3300
245000004, 45, 4, 0, 0, 1, 0, 0, 0, 0
245000005, 45, 5, 0, 0, 1, 0, 0, 0, 0
145000007, 45, 7, 0, 1, 0, 1, 15215, 12535, 2680
145000006, 45, 6, 0, 1, 0, 1, 15255, 7535, 7720
245000005, 45, 5, 0, 0, 1, 0, 0, 0, 0
145000007, 45, 7, 0, 1, 0, 1, 15335, 12635, 2700
145000004, 45, 4, 0, 1, 0, 1, 15375, 10435, 4940
245000004, 45, 4, 0, 0, 1, 0, 0, 0, 0
145000007, 45, 7, 0, 1, 0, 1, 15455, 12735, 2720
145000006, 45, 6, 0, 1, 0, 1, 15495, 7635, 7860
245000004, 45, 4, 0, 0, 1, 0, 0, 0, 0
245000005, 45, 5, 0, 0, 1, 0, 0, 0, 0
145000007, 45, 7, 0, 1, 0, 1, 15575, 12835, 2740
145000006, 45, 6, 0, 1, 0, 1, 15615, 7735, 7880
245000005, 45, 5, 0, 0, 1, 0, 0, 0, 0
145000007, 45, 7, 0, 1, 0, 1, 15695, 12935, 2760
145000005, 45, 5, 0, 1, 0, 1, 15735, 12335, 3400
245000004, 45, 4, 0, 0, 1, 0, 0, 0, 0
245000005, 45, 5, 0, 0, 1, 0, 0, 0, 0
145000007, 45, 7, 0, 1, 0, 1, 15815, 13035, 2780
145000006, 45, 6, 0, 1, 0, 1, 15855, 7835, 8020
245000005, 45, 5, 0, 0, 1, 0, 0, 0, 0
145000007, 45, 7, 0, 1, 0, 1, 15935, 13135, 2800
145000004, 45, 4, 0, 1, 0, 1, 15975, 10915, 5060
245000004, 45, 4, 0, 0, 1, 0, 0, 0, 0
145000007, 45, 7, 0, 1, 0, 1, 16055, 13235, 2820
145000006, 45, 6, 0, 1, 0, 1, 16095, 7935, 8160
245000004, 45, 4, 0, 0, 1, 0, 0, 0, 0
245000005, 45, 5, 0, 0, 1, 0, 0, 0, 0
145000007, 45, 7, 0, 1, 0, 1, 16175, 13335, 2840
145000006, 45, 6, 0, 1, 0, 1, 16215, 8035, 8180
245000005, 45, 5, 0, 0, 1, 0, 0, 0, 0
145000007, 45, 7, 0, 1, 0, 1, 16295, 13435, 2860
145000005, 45, 5, 0, 1, 0, 1, 16335, 12835, 3500
245000004, 45, 4, 0, 0, 1, 0, 0, 0, 0
245000005, 45, 5, 0, 0, 1, 0, 0, 0, 0
145000007, 45, 7, 0, 1, 0, 1, 16415, 13535, 2880
145000006, 45, 6, 0, 1, 0, 1, 16455, 8135, 8320
245000005, 45, 5, 0, 0, 1, 0, 0, 0, 0
145000007, 45, 7, 0, 1, 0, 1, 16535, 13635, 2900
145000004, 45, 4, 0, 1, 0, 1, 16575, 11395, 5180
245000004, 45, 4, 0, 0, 1, 0, 0, 0, 0
145000007, 45, 7, 0, 1, 0, 1, 16655, 13735, 2920
145000006, 45, 6, 0, 1, 0, 1, 16695, 8235, 8460
245000004, 45, 4, 0, 0, 1, 0, 0, 0, 0
245000005, 45, 5, 0, 0, 1, 0, 0, 0, 0
145000007, 45, 7, 0, 1, 0, 1, 16775, 13835, 2940
145000006, 45, 6, 0, 1, 0, 1, 16815, 8335, 8480
245000005, 45, 5, 0, 0, 1, 0, 0, 0, 0
145000007, 45, 7, 0, 1, 0, 1, 16895, 13935, 2960
145000005, 45, 5, 0, 1, 0, 1, 16935, 13335, 3600
245000004, 45, 4, 0, 0, 1, 0, 0, 0, 0
245000005, 45, 5, 0, 0, 1, 0, 0, 0, 0
145000007, 45, 7, 0, 1, 0, 1, 17015, 14035, 2980
145000006, 45, 6, 0, 1, 0, 1, 17055, 8435, 8620
245000005, 45, 5, 0, 0, 1, 0, 0, 0, 0
145000007, 45, 7, 0, 1, 0, 1, 17135, 14135, 3000
145000004, 45, 4, 0, 1, 0, 1, 17175, 11875, 5300
245000004, 45, 4, 0, 0, 1, 0, 0, 0, 0
145000007, 45, 7, 0, 1, 0, 1, 17255, 14235, 3020
145000006, 45, 6, 0, 1, 0, 1, 17295, 8535, 8760
245000004, 45, 4, 0, 0, 1, 0, 0, 0, 0
245000005, 45, 5, 0, 0, 1, 0, 0, 0, 0
145000007, 45, 7, 0, 1, 0, 1, 17375, 14335, 3040
145000006, 45, 6, 0, 1, 0, 1, 17415, 8635, 8780
245000005, 45, 5, 0, 0, 1, 0, 0, 0, 0
145000007, 45, 7, 0, 1, 0, 1, 17495, 14435, 3060
145000005, 45, 5, 0, 1, 0, 1, 17535, 13835, 3700
245000004, 45, 4, 0, 0, 1, 0, 0, 0, 0
245000005, 45, 5, 0, 0, 1, 0, 0, 0, 0
145000007, 45, 7, 0, 1, 0, 1, 17615, 14535, 3080
145000006, 45, 6, 0, 1, 0, 1, 17655, 8735, 8920
245000005, 45, 5, 0, 0, 1, 0, 0, 0, 0
145000007, 45, 7, 0, 1, 0, 1, 17735, 14635, 3100
145000004, 45, 4, 0, 1, 0, 1, 17775, 12355, 5420
245000004, 45, 4, 0, 0, 1, 0, 0, 0, 0
145000007, 45, 7, 0, 1, 0, 1, 17855, 14735, 3120
145000006, 45, 6, 0, 1, 0, 1, 17895, 8835, 9060
245000004, 45, 4, 0, 0, 1, 0, 0, 0, 0
245000005, 45, 5, 0, 0, 1, 0, 0, 0, 0
145000007, 45, 7, 0, 1, 0, 1, 17975, 14835, 3140
145000006, 45, 6, 0, 1, 0, 1, 18015, 8935, 9080
245000005, 45, 5, 0, 0, 1, 0, 0, 0, 0
145000007, 45, 7, 0, 1, 0, 1, 18095, 14935, 3160
145000005, 45, 5, 0, 1, 0, 1, 18135, 14335, 3800
245000004, 45, 4, 0, 0, 1, 0, 0, 0, 0
245000005, 45, 5, 0, 0, 1, 0, 0, 0, 0
145000007, 45, 7, 0, 1, 0, 1, 18215, 15035, 3180
145000006, 45, 6, 0, 1, 0, 1, 18255, 9035, 9220
245000005, 45, 5, 0, 0, 1, 0, 0, 0, 0
145000007, 45, 7, 0, 1, 0, 1, 18335, 15135, 3200
145000004, 45, 4, 0, 1, 0, 1, 18375, 12835, 5540
245000004, 45, 4, 0, 0, 1, 0, 0, 0, 0
145000007, 45, 7, 0, 1, 0, 1, 18455, 15235, 3220
145000006, 45, 6, 0, 1, 0, 1, 18495, 9135, 9360
245000004, 45, 4, 0, 0, 1, 0, 0, 0, 0
245000005, 45, 5, 0, 0, 1, 0, 0, 0, 0
145000007, 45, 7, 0, 1, 0, 1, 18575, 15335, 3240
145000006, 45, 6, 0, 1, 0, 1, 18615, 9235, 9380
245000005, 45, 5, 0, 0, 1, 0, 0, 0, 0
145000007, 45, 7, 0, 1, 0, 1, 18695, 15435, 3260
145000005, 45, 5, 0, 1, 0, 1, 18735, 14835, 3900
245000004, 45, 4, 0, 0, 1, 0, 0, 0, 0
245000005, 45, 5, 0, 0, 1, 0, 0, 0, 0
145000007, 45, 7, 0, 1, 0, 1, 18815, 15535, 3280
145000006, 45, 6, 0, 1, 0, 1, 18855, 9335, 9520
245000005, 45, 5, 0, 0, 1, 0, 0, 0, 0
145000007, 45, 7, 0, 1, 0, 1, 18935, 15635, 3300
145000004, 45, 4, 0, 1, 0, 1, 18975, 13315, 5660
245000004, 45, 4, 0, 0, 1, 0, 0, 0, 0
145000007, 45, 7, 0, 1, 0, 1, 19055, 15735, 3320
145000006, 45, 6, 0, 1, 0, 1, 19095, 9435, 9660
245000004, 45, 4, 0, 0, 1, 0, 0, 0, 0
245000005, 45, 5, 0, 0, 1, 0, 0, 0, 0
145000007, 45, 7, 0, 1, 0, 1, 19175, 15835, 3340
145000006, 45, 6, 0, 1, 0, 1, 19215, 9535, 9680
245000005, 45, 5, 0, 0, 1, 0, 0, 0, 0
145000007, 45, 7, 0, 1, 0, 1, 19295, 15935, 3360
145000005, 45, 5, 0, 1, 0, 1, 19335, 15335, 4000
245000004, 45, 4, 0, 0, 1, 0, 0, 0, 0
245000005, 45, 5, 0, 0, 1, 0, 0, 0, 0
145000007, 45, 7, 0, 1, 0, 1, 19415, 16035, 3380
145000006, 45, 6, 0, 1, 0, 1, 19455, 9635, 9820
245000005, 45, 5, 0, 0, 1, 0, 0, 0, 0
145000007, 45, 7, 0, 1, 0, 1, 19535, 16135, 3400
145000004, 45, 4, 0, 1, 0, 1, 19575, 13795, 5780
245000004, 45, 4, 0, 0, 1, 0, 0, 0, 0
145000007, 45, 7, 0, 1, 0, 1, 19655, 16235, 3420
145000006, 45, 6, 0, 1, 0, 1, 19695, 9735, 9960
245000004, 45, 4, 0, 0, 1, 0, 0, 0, 0
245000005, 45, 5, 0, 0, 1, 0, 0, 0, 0
145000007, 45, 7, 0, 1, 0, 1, 19775, 16335, 3440
145000006, 45, 6, 0, 1, 0, 1, 19815, 9835, 9980
245000005, 45, 5, 0, 0, 1, 0, 0, 0, 0
145000007, 45, 7, 0, 1, 0, 1, 19895, 16435, 3460
145000005, 45, 5, 0, 1, 0, 1, 19935, 15835, 4100
245000004, 45, 4, 0, 0, 1, 0, 0, 0, 0
245000005, 45, 5, 0, 0, 1, 0, 0, 0, 0
145000007, 45, 7, 0, 1, 0, 1, 20015, 16535, 3480
145000006, 45, 6, 0, 1, 0, 1, 20055, 9935, 10120
245000005, 45, 5, 0, 0, 1, 0, 0, 0, 0
145000007, 45, 7, 0, 1, 0, 1, 20135, 16635, 3500
145000004, 45, 4, 0, 1, 0, 1, 20175, 14275, 5900
245000004, 45, 4, 0, 0, 1, 0, 0, 0, 0
145000007, 45, 7, 0, 1, 0, 1, 20255, 16735, 3520
145000006, 45, 6, 0, 1, 0, 1, 20295, 10035, 10260
245000004, 45, 4, 0, 0, 1, 0, 0, 0, 0
245000005, 45, 5, 0, 0, 1, 0, 0, 0, 0
145000007, 45, 7, 0, 1, 0, 1, 20375, 16835, 3540
145000006, 45, 6, 0, 1, 0, 1, 20415, 10135, 10280
245000005, 45, 5, 0, 0, 1, 0, 0, 0, 0
145000007, 45, 7, 0, 1, 0, 1, 20495, 16935, 3560
145000005, 45, 5, 0, 1, 0, 1, 20535, 16335, 4200
245000004, 45, 4, 0, 0, 1, 0, 0, 0, 0
245000005, 45, 5, 0, 0, 1, 0, 0, 0, 0
145000007, 45, 7, 0, 1, 0, 1, 20615, 17035, 3580
145000006, 45, 6, 0, 1, 0, 1, 20655, 10235, 10420
245000005, 45, 5, 0, 0, 1, 0, 0, 0, 0
145000007, 45, 7, 0, 1, 0, 1, 20735, 17135, 3600
145000004, 45, 4, 0, 1, 0, 1, 20775, 14755, 6020
245000004, 45, 4, 0, 0, 1, 0, 0, 0, 0
145000007, 45, 7, 0, 1, 0, 1, 20855, 17235, 3620
145000006, 45, 6, 0, 1, 0, 1, 20895, 10335, 10560
245000004, 45, 4, 0, 0, 1, 0, 0, 0, 0
245000005, 45, 5, 0, 0, 1, 0, 0, 0, 0
145000007, 45, 7, 0, 1, 0, 1, 20975, 17335, 3640
145000006, 45, 6, 0, 1, 0, 1, 21015, 10435, 10580
245000005, 45, 5, 0, 0, 1, 0, 0, 0, 0
145000007, 45, 7, 0, 1, 0, 1, 21095, 17435, 3660
145000005, 45, 5, 0, 1, 0, 1, 21135, 16835, 4300
245000004, 45, 4, 0, 0, 1, 0, 0, 0, 0
245000005, 45, 5, 0, 0, 1, 0, 0, 0, 0
145000007, 45, 7, 0, 1, 0, 1, 21215, 17535, 3680
145000006, 45, 6, 0, 1, 0, 1, 21255, 10535, 10720
245000005, 45, 5, 0, 0, 1, 0, 0, 0, 0
145000007, 45, 7, 0, 1, 0, 1, 21335, 17635, 3700
145000004, 45, 4, 0, 1, 0, 1, 21375, 15235, 6140
245000004, 45, 4, 0, 0, 1, 0, 0, 0, 0
145000007, 45, 7, 0, 1, 0, 1, 21455, 17735, 3720
145000006, 45, 6, 0, 1, 0, 1, 21495, 10635, 10860
245000004, 45, 4, 0, 0, 1, 0, 0, 0, 0
245000005, 45, 5, 0, 0, 1, 0, 0, 0, 0
145000007, 45, 7, 0, 1, 0, 1, 21575, 17835, 3740
145000006, 45, 6, 0, 1, 0, 1, 21615, 10735, 10880
245000005, 45, 5, 0, 0, 1, 0, 0, 0, 0
145000007, 45, 7, 0, 1, 0, 1, 21695, 17935, 3760
145000005, 45, 5, 0, 1, 0, 1, 21735, 17335, 4400
245000004, 45, 4, 0, 0, 1, 0, 0, 0, 0
245000005, 45, 5, 0, 0, 1, 0, 0, 0, 0
145000007, 45, 7, 0, 1, 0, 1, 21815, 18035, 3780
145000006, 45, 6, 0, 1, 0, 1, 21855, 10835, 11020
245000005, 45, 5, 0, 0, 1, 0, 0, 0, 0
145000007, 45, 7, 0, 1, 0, 1, 21935, 18135, 3800
145000004, 45, 4, 0, 1, 0, 1, 21975, 15715, 6260
245000004, 45, 4, 0, 0, 1, 0, 0, 0, 0
145000007, 45, 7, 0, 1, 0, 1, 22055, 18235, 3820
145000006, 45, 6, 0, 1, 0, 1, 22095, 10935, 11160
245000004, 45, 4, 0, 0, 1, 0, 0, 0, 0
245000005, 45, 5, 0, 0, 1, 0, 0, 0, 0
145000007, 45, 7, 0, 1, 0, 1, 22175, 18335, 3840
145000006, 45, 6, 0, 1, 0, 1, 22215, 11035, 11180
245000005, 45, 5, 0, 0, 1, 0, 0, 0, 0
145000007, 45, 7, 0, 1, 0, 1, 22295, 18435, 3860
145000005, 45, 5, 0, 1, 0, 1, 22335, 17835, 4500
245000004, 45, 4, 0, 0, 1, 0, 0, 0, 0
245000005, 45, 5, 0, 0, 1, 0, 0, 0, 0
145000007, 45, 7, 0, 1, 0, 1, 22415, 18535, 3880
145000006, 45, 6, 0, 1, 0, 1, 22455, 11135, 11320
245000005, 45, 5, 0, 0, 1, 0, 0, 0, 0
145000007, 45, 7, 0, 1, 0, 1, 22535, 18635, 3900
145000004, 45, 4, 0, 1, 0, 1, 22575, 16195, 6380
245000004, 45, 4, 0, 0, 1, 0, 0, 0, 0
145000007, 45, 7, 0, 1, 0, 1, 22655, 18735, 3920
145000006, 45, 6, 0, 1, 0, 1, 22695, 11235, 11460
245000004, 45, 4, 0, 0, 1, 0, 0, 0, 0
245000005, 45, 5, 0, 0, 1, 0, 0, 0, 0
145000007, 45, 7, 0, 1, 0, 1, 22775, 18835, 3940
145000006, 45, 6, 0, 1, 0, 1, 22815, 11335, 11480
245000005, 45, 5, 0, 0, 1, 0, 0, 0, 0
145000007, 45, 7, 0, 1, 0, 1, 22895, 18935, 3960
145000005, 45, 5, 0, 1, 0, 1, 22935, 18335, 4600
245000004, 45, 4, 0, 0, 1, 0, 0, 0, 0
245000005, 45, 5, 0, 0, 1, 0, 0, 0, 0
145000007, 45, 7, 0, 1, 0, 1, 23015, 19035, 3980
145000006, 45, 6, 0, 1, 0, 1, 23055, 11435, 11620
245000005, 45, 5, 0, 0, 1, 0, 0, 0, 0
145000007, 45, 7, 0, 1, 0, 1, 23135, 19135, 4000
145000004, 45, 4, 0, 1, 0, 1, 23175, 16675, 6500
245000004, 45, 4, 0, 0, 1, 0, 0, 0, 0
145000007, 45, 7, 0, 1, 0, 1, 23255, 19235, 4020
145000006, 45, 6, 0, 1, 0, 1, 23295, 11535, 11760
245000004, 45, 4, 0, 0, 1, 0, 0, 0, 0
245000005, 45, 5, 0, 0, 1, 0, 0, 0, 0
145000007, 45, 7, 0, 1, 0, 1, 23375, 19335, 4040
145000006, 45, 6, 0, 1, 0, 1, 23415, 11635, 11780
245000005, 45, 5, 0, 0, 1, 0, 0, 0, 0
145000007, 45, 7, 0, 1, 0, 1, 23495, 19435, 4060
145000005, 45, 5, 0, 1, 0, 1, 23535, 18835, 4700
245000004, 45, 4, 0, 0, 1, 0, 0, 0, 0
245000005, 45, 5, 0, 0, 1, 0, 0, 0, 0
145000007, 45, 7, 0, 1, 0, 1, 23615, 19535, 4080
145000006, 45, 6, 0, 1, 0, 1, 23655, 11735, 11920
245000005, 45, 5, 0, 0, 1, 0, 0, 0, 0
145000007, 45, 7, 0, 1, 0, 1, 23735, 19635, 4100
145000004, 45, 4, 0, 1, 0, 1, 23775, 17155, 6620
245000004, 45, 4, 0, 0, 1, 0, 0, 0, 0
145000007, 45, 7, 0, 1, 0, 1, 23855, 19735, 4120
145000006, 45, 6, 0, 1, 0, 1, 23895, 11835, 12060
245000004, 45, 4, 0, 0, 1, 0, 0, 0, 0
245000005, 45, 5, 0, 0, 1, 0, 0, 0, 0
145000007, 45, 7, 0, 1, 0, 1, 23975, 19835, 4140
145000006, 45, 6, 0, 1, 0, 1, 24015, 11935, 12080
245000005, 45, 5, 0, 0, 1, 0, 0, 0, 0
145000007, 45, 7, 0, 1, 0, 1, 24095, 19935, 4160
145000005, 45, 5, 0, 1, 0, 1, 24135, 19335, 4800
245000004, 45, 4, 0, 0, 1, 0, 0, 0, 0
245000005, 45, 5, 0, 0, 1, 0, 0, 0, 0
145000007, 45, 7, 0, 1, 0, 1, 24215, 20035, 4180
145000006, 45, 6, 0, 1, 0, 1, 24255, 12035, 12220
245000005, 45, 5, 0, 0, 1, 0, 0, 0, 0
145000007, 45, 7, 0, 1, 0, 1, 24335, 20135, 4200
145000004, 45, 4, 0, 1, 0, 1, 24375, 17635, 6740
245000004, 45, 4, 0, 0, 1, 0, 0, 0, 0
145000007, 45, 7, 0, 1, 0, 1, 24455, 20235, 4220
145000006, 45, 6, 0, 1, 0, 1, 24495, 12135, 12360
245000004, 45, 4, 0, 0, 1, 0, 0, 0, 0
245000005, 45, 5, 0, 0, 1, 0, 0, 0, 0
145000007, 45, 7, 0, 1, 0, 1, 24575, 20335, 4240
145000006, 45, 6, 0, 1, 0, 1, 24615, 12235, 12380
245000005, 45, 5, 0, 0, 1, 0, 0, 0, 0
145000007, 45, 7, 0, 1, 0, 1, 24695, 20435, 4260
145000005, 45, 5, 0, 1, 0, 1, 24735, 19835, 4900
245000004, 45, 4, 0, 0, 1, 0, 0, 0, 0
245000005, 45, 5, 0, 0, 1, 0, 0, 0, 0
145000007, 45, 7, 0, 1, 0, 1, 24815, 20535, 4280
145000006, 45, 6, 0, 1, 0, 1, 24855, 12335, 12520
245000005, 45, 5, 0, 0, 1, 0, 0, 0, 0
145000007, 45, 7, 0, 1, 0, 1, 24935, 20635, 4300
145000004, 45, 4, 0, 1, 0, 1, 24975, 18115, 6860
245000004, 45, 4, 0, 0, 1, 0, 0, 0, 0
145000007, 45, 7, 0, 1, 0, 1, 25055, 20735, 4320
145000006, 45, 6, 0, 1, 0, 1, 25095, 12435, 12660
245000004, 45, 4, 0, 0, 1, 0, 0, 0, 0
245000005, 45, 5, 0, 0, 1, 0, 0, 0, 0
145000007, 45, 7, 0, 1, 0, 1, 25175, 20835, 4340
145000006, 45, 6, 0, 1, 0, 1, 25215, 12535, 12680
245000005, 45, 5, 0, 0, 1, 0, 0, 0, 0
145000007, 45, 7, 0, 1, 0, 1, 25295, 20935, 4360
145000005, 45, 5, 0, 1, 0, 1, 25335, 20335, 5000
245000004, 45, 4, 0, 0, 1, 0, 0, 0, 0
245000005, 45, 5, 0, 0, 1, 0, 0, 0, 0
145000007, 45, 7, 0, 1, 0, 1, 25415, 21035, 4380
145000006, 45, 6, 0, 1, 0, 1, 25455, 12635, 12820
245000005, 45, 5, 0, 0, 1, 0, 0, 0, 0
145000007, 45, 7, 0, 1, 0, 1, 25535, 21135, 4400
145000004, 45, 4, 0, 1, 0, 1, 25575, 18595, 6980
245000004, 45, 4, 0, 0, 1, 0, 0, 0, 0
145000007, 45, 7, 0, 1, 0, 1, 25655, 21235, 4420
145000006, 45, 6, 0, 1, 0, 1, 25695, 12735, 12960
245000004, 45, 4, 0, 0, 1, 0, 0, 0, 0
245000005, 45, 5, 0, 0, 1, 0, 0, 0, 0
145000007, 45, 7, 0, 1, 0, 1, 25775, 21335, 4440
145000006, 45, 6, 0, 1, 0, 1, 25815, 12835, 12980
245000005, 45, 5, 0, 0, 1, 0, 0, 0, 0
145000007, 45, 7, 0, 1, 0, 1, 25895, 21435, 4460
145000005, 45, 5, 0, 1, 0, 1, 25935, 20835, 5100
245000004, 45, 4, 0, 0, 1, 0, 0, 0, 0
245000005, 45, 5, 0, 0, 1, 0, 0, 0, 0
145000007, 45, 7, 0, 1, 0, 1, 26015, 21535, 4480
145000006, 45, 6, 0, 1, 0, 1, 26055, 12935, 13120
245000005, 45, 5, 0, 0, 1, 0, 0, 0, 0
145000007, 45, 7, 0, 1, 0, 1, 26135, 21635, 4500
145000004, 45, 4, 0, 1, 0, 1, 26175, 19075, 7100
245000004, 45, 4, 0, 0, 1, 0, 0, 0, 0
145000007, 45, 7, 0, 1, 0, 1, 26255, 21735, 4520
145000006, 45, 6, 0, 1, 0, 1, 26295, 13035, 13260
245000004, 45, 4, 0, 0, 1, 0, 0, 0, 0
245000005, 45, 5, 0, 0, 1, 0, 0, 0, 0
145000007, 45, 7, 0, 1, 0, 1, 26375, 21835, 4540
145000006, 45, 6, 0, 1, 0, 1, 26415, 13135, 13280
245000005, 45, 5, 0, 0, 1, 0, 0, 0, 0
145000007, 45, 7, 0, 1, 0, 1, 26495, 21935, 4560
145000005, 45, 5, 0, 1, 0, 1, 26535, 21335, 5200
245000004, 45, 4, 0, 0, 1, 0, 0, 0, 0
245000005, 45, 5, 0, 0, 1, 0, 0, 0, 0
145000007, 45, 7, 0, 1, 0, 1, 26615, 22035, 4580
145000006, 45, 6, 0, 1, 0, 1, 26655, 13235, 13420
245000005, 45, 5, 0, 0, 1, 0, 0, 0, 0
145000007, 45, 7, 0, 1, 0, 1, 26735, 22135, 4600
145000004, 45, 4, 0, 1, 0, 1, 26775, 19555, 7220
245000004, 45, 4, 0, 0, 1, 0, 0, 0, 0
145000007, 45, 7, 0, 1, 0, 1, 26855, 22235, 4620
145000006, 45, 6, 0, 1, 0, 1, 26895, 13335, 13560
245000004, 45, 4, 0, 0, 1, 0, 0, 0, 0
245000005, 45, 5, 0, 0, 1, 0, 0, 0, 0
145000007, 45, 7, 0, 1, 0, 1, 26975, 22335, 4640
145000006, 45, 6, 0, 1, 0, 1, 27015, 13435, 13580
245000005, 45, 5, 0, 0, 1, 0, 0, 0, 0
145000007, 45, 7, 0, 1, 0, 1, 27095, 22435, 4660
145000005, 45, 5, 0, 1, 0, 1, 27135, 21835, 5300
245000004, 45, 4, 0, 0, 1, 0, 0, 0, 0
245000005, 45, 5, 0, 0, 1, 0, 0, 0, 0
145000007, 45, 7, 0, 1, 0, 1, 27215, 22535, 4680
145000006, 45, 6, 0, 1, 0, 1, 27255, 13535, 13720
245000005, 45, 5, 0, 0, 1, 0, 0, 0, 0
145000007, 45, 7, 0, 1, 0, 1, 27335, 22635, 4700
145000004, 45, 4, 0, 1, 0, 1, 27375, 20035, 7340
245000004, 45, 4, 0, 0, 1, 0, 0, 0, 0
145000007, 45, 7, 0, 1, 0, 1, 27455, 22735, 4720
145000006, 45, 6, 0, 1, 0, 1, 27495, 13635, 13860
245000004, 45, 4, 0, 0, 1, 0, 0, 0, 0
245000005, 45, 5, 0, 0, 1, 0, 0, 0, 0
145000007, 45, 7, 0, 1, 0, 1, 27575, 22835, 4740
145000006, 45, 6, 0, 1, 0, 1, 27615, 13735, 13880
245000005, 45, 5, 0, 0, 1, 0, 0, 0, 0
145000007, 45, 7, 0, 1, 0, 1, 27695, 22935, 4760
145000005, 45, 5, 0, 1, 0, 1, 27735, 22335, 5400
245000004, 45, 4, 0, 0, 1, 0, 0, 0, 0
245000005, 45, 5, 0, 0, 1, 0, 0, 0, 0
145000007, 45, 7, 0, 1, 0, 1, 27815, 23035, 4780
145000006, 45, 6, 0, 1, 0, 1, 27855, 13835, 14020
245000005, 45, 5, 0, 0, 1, 0, 0, 0, 0
145000007, 45, 7, 0, 1, 0, 1, 27935, 23135, 4800
145000004, 45, 4, 0, 1, 0, 1, 27975, 20515, 7460
245000004, 45, 4, 0, 0, 1, 0, 0, 0, 0
145000007, 45, 7, 0, 1, 0, 1, 28055, 23235, 4820
145000006, 45, 6, 0, 1, 0, 1, 28095, 13935, 14160
245000004, 45, 4, 0, 0, 1, 0, 0, 0, 0
245000005, 45, 5, 0, 0, 1, 0, 0, 0, 0
145000007, 45, 7, 0, 1, 0, 1, 28175, 23335, 4840
145000006, 45, 6, 0, 1, 0, 1, 28215, 14035, 14180
245000005, 45, 5, 0, 0, 1, 0, 0, 0, 0
145000007, 45, 7, 0, 1, 0, 1, 28295, 23435, 4860
145000005, 45, 5, 0, 1, 0, 1, 28335, 22835, 5500
245000004, 45, 4, 0, 0, 1, 0, 0, 0, 0
245000005, 45, 5, 0, 0, 1, 0, 0, 0, 0
145000007, 45, 7, 0, 1, 0, 1, 28415, 23535, 4880
145000006, 45, 6, 0, 1, 0, 1, 28455, 14135, 14320
245000005, 45, 5, 0, 0, 1, 0, 0, 0, 0
145000007, 45, 7, 0, 1, 0, 1, 28535, 23635, 4900
145000004, 45, 4, 0, 1, 0, 1, 28575, 20995, 7580
245000004, 45, 4, 0, 0, 1, 0, 0, 0, 0
145000007, 45, 7, 0, 1, 0, 1, 28655, 23735, 4920
145000006, 45, 6, 0, 1, 0, 1, 28695, 14235, 14460
245000004, 45, 4, 0, 0, 1, 0, 0, 0, 0
245000005, 45, 5, 0, 0, 1, 0, 0, 0, 0
145000007, 45, 7, 0, 1, 0, 1, 28775, 23835, 4940
145000006, 45, 6, 0, 1, 0, 1, 28815, 14335, 14480
245000005, 45, 5, 0, 0, 1, 0, 0, 0, 0
145000007, 45, 7, 0, 1, 0, 1, 28895, 23935, 4960
145000005, 45, 5, 0, 1, 0, 1, 28935, 23335, 5600
245000004, 45, 4, 0, 0, 1, 0, 0, 0, 0
245000005, 45, 5, 0, 0, 1, 0, 0, 0, 0
145000007, 45, 7, 0, 1, 0, 1, 29015, 24035, 4980
145000006, 45, 6, 0, 1, 0, 1, 29055, 14435, 14620
245000005, 45, 5, 0, 0, 1, 0, 0, 0, 0
145000007, 45, 7, 0, 1, 0, 1, 29135, 24135, 5000
145000004, 45, 4, 0, 1, 0, 1, 29175, 21475, 7700
245000004, 45, 4, 0, 0, 1, 0, 0, 0, 0
145000007, 45, 7, 0, 1, 0, 1, 29255, 24235, 5020
145000006, 45, 6, 0, 1, 0, 1, 29295, 14535, 14760
245000004, 45, 4, 0, 0, 1, 0, 0, 0, 0
245000005, 45, 5, 0, 0, 1, 0, 0, 0, 0
145000007, 45, 7, 0, 1, 0, 1, 29375, 24335, 5040
145000006, 45, 6, 0, 1, 0, 1, 29415, 14635, 14780
245000005, 45, 5, 0, 0, 1, 0, 0, 0, 0
145000007, 45, 7, 0, 1, 0, 1, 29495, 24435, 5060
145000005, 45, 5, 0, 1, 0, 1, 29535, 23835, 5700
245000004, 45, 4, 0, 0, 1, 0, 0, 0, 0
245000005, 45, 5, 0, 0, 1, 0, 0, 0, 0
145000007, 45, 7, 0, 1, 0, 1, 29615, 24535, 5080
145000006, 45, 6, 0, 1, 0, 1, 29655, 14735, 14920
245000005, 45, 5, 0, 0, 1, 0, 0, 0, 0
145000007, 45, 7, 0, 1, 0, 1, 29735, 24635, 5100
145000004, 45, 4, 0, 1, 0, 1, 29775, 21955, 7820
245000004, 45, 4, 0, 0, 1, 0, 0, 0, 0
145000007, 45, 7, 0, 1, 0, 1, 29855, 24735, 5120
145000006, 45, 6, 0, 1, 0, 1, 29895, 14835, 15060
245000004, 45, 4, 0, 0, 1, 0, 0, 0, 0
245000005, 45, 5, 0, 0, 1, 0, 0, 0, 0
145000007, 45, 7, 0, 1, 0, 1, 29975, 24835, 5140
145000006, 45, 6, 0, 1, 0, 1, 30015, 14935, 15080
245000005, 45, 5, 0, 0, 1, 0, 0, 0, 0
145000007, 45, 7, 0, 1, 0, 1, 30095, 24935, 5160
145000005, 45, 5, 0, 1, 0, 1, 30135, 24335, 5800
245000004, 45, 4, 0, 0, 1, 0, 0, 0, 0
245000005, 45, 5, 0, 0, 1, 0, 0, 0, 0
145000007, 45, 7, 0, 1, 0, 1, 30215, 25035, 5180
145000006, 45, 6, 0, 1, 0, 1, 30255, 15035, 15220
245000005, 45, 5, 0, 0, 1, 0, 0, 0, 0
145000007, 45, 7, 0, 1, 0, 1, 30335, 25135, 5200
145000004, 45, 4, 0, 1, 0, 1, 30375, 22435, 7940
245000004, 45, 4, 0, 0, 1, 0, 0, 0, 0
145000007, 45, 7, 0, 1, 0, 1, 30455, 25235, 5220
145000006, 45, 6, 0, 1, 0, 1, 30495, 15135, 15360
245000004, 45, 4, 0, 0, 1, 0, 0, 0, 0
245000005, 45, 5, 0, 0, 1, 0, 0, 0, 0
145000007, 45, 7, 0, 1, 0, 1, 30575, 25335, 5240
145000006, 45, 6, 0, 1, 0, 1, 30615, 15235, 15380
245000005, 45, 5, 0, 0, 1, 0, 0, 0, 0
145000007, 45, 7, 0, 1, 0, 1, 30695, 25435, 5260
145000005, 45, 5, 0, 1, 0, 1, 30735, 24835, 5900
245000004, 45, 4, 0, 0, 1, 0, 0, 0, 0
245000005, 45, 5, 0, 0, 1, 0, 0, 0, 0
145000007, 45, 7, 0, 1, 0, 1, 30815, 25535, 5280
145000006, 45, 6, 0, 1, 0, 1, 30855, 15335, 15520
245000005, 45, 5, 0, 0, 1, 0, 0, 0, 0
145000007, 45, 7, 0, 1, 0, 1, 30935, 25635, 5300
145000004, 45, 4, 0, 1, 0, 1, 30975, 22915, 8060
245000004, 45, 4, 0, 0, 1, 0, 0, 0, 0
145000007, 45, 7, 0, 1, 0, 1, 31055, 25735, 5320
145000006, 45, 6, 0, 1, 0, 1, 31095, 15435, 15660
245000004, 45, 4, 0, 0, 1, 0, 0, 0, 0
245000005, 45, 5, 0, 0, 1, 0, 0, 0, 0
145000007, 45, 7, 0, 1, 0, 1, 31175, 25835, 5340
145000006, 45, 6, 0, 1, 0, 1, 31215, 15535, 15680
245000005, 45, 5, 0, 0, 1, 0, 0, 0, 0
145000007, 45, 7, 0, 1, 0, 1, 31295, 25935, 5360
145000005, 45, 5, 0, 1, 0, 1, 31335, 25335, 6000
245000004, 45, 4, 0, 0, 1, 0, 0, 0, 0
245000005, 45, 5, 0, 0, 1, 0, 0, 0, 0
145000007, 45, 7, 0, 1, 0, 1, 31415, 26035, 5380
145000006, 45, 6, 0, 1, 0, 1, 31455, 15635, 15820
245000005, 45, 5, 0, 0, 1, 0, 0, 0, 0
145000007, 45, 7, 0, 1, 0, 1, 31535, 26135, 5400
145000004, 45, 4, 0, 1, 0, 1, 31575, 23395, 8180
245000004, 45, 4, 0, 0, 1, 0, 0, 0, 0
145000007, 45, 7, 0, 1, 0, 1, 31655, 26235, 5420
145000006, 45, 6, 0, 1, 0, 1, 31695, 15735, 15960
245000004, 45, 4, 0, 0, 1, 0, 0, 0, 0
245000005, 45, 5, 0, 0, 1, 0, 0, 0, 0
145000007, 45, 7, 0, 1, 0, 1, 31775, 26335, 5440
145000006, 45, 6, 0, 1, 0, 1, 31815, 15835, 15980
245000005, 45, 5, 0, 0, 1, 0, 0, 0, 0
145000007, 45, 7, 0, 1, 0, 1, 31895, 26435, 5460
145000005, 45, 5, 0, 1, 0, 1, 31935, 25835, 6100
245000004, 45, 4, 0, 0, 1, 0, 0, 0, 0
245000005, 45, 5, 0, 0, 1, 0, 0, 0, 0
145000007, 45, 7, 0, 1, 0, 1, 32015, 26535, 5480
145000006, 45, 6, 0, 1, 0, 1, 32055, 15935, 16120
245000005, 45, 5, 0, 0, 1, 0, 0, 0, 0
145000007, 45, 7, 0, 1, 0, 1, 32135, 26635, 5500
145000004, 45, 4, 0, 1, 0, 1, 32175, 23875, 8300
245000004, 45, 4, 0, 0, 1, 0, 0, 0, 0
145000007, 45, 7, 0, 1, 0, 1, 32255, 26735, 5520
145000006, 45, 6, 0, 1, 0, 1, 32295, 16035, 16260
245000004, 45, 4, 0, 0, 1, 0, 0, 0, 0
245000005, 45, 5, 0, 0, 1, 0, 0, 0, 0
145000007, 45, 7, 0, 1, 0, 1, 32375, 26835, 5540
145000006, 45, 6, 0, 1, 0, 1, 32415, 16135, 16280
245000005, 45, 5, 0, 0, 1, 0, 0, 0, 0
145000007, 45, 7, 0, 1, 0, 1, 32495, 26935, 5560
145000005, 45, 5, 0, 1, 0, 1, 32535, 26335, 6200
245000004, 45, 4, 0, 0, 1, 0, 0, 0, 0
245000005, 45, 5, 0, 0, 1, 0, 0, 0, 0
145000007, 45, 7, 0, 1, 0, 1, 32615, 27035, 5580
145000006, 45, 6, 0, 1, 0, 1, 32655, 16235, 16420
245000005, 45, 5, 0, 0, 1, 0, 0, 0, 0
145000007, 45, 7, 0, 1, 0, 1, 32735, 27135, 5600
145000004, 45, 4, 0, 1, 0, 1, 32775, 24355, 8420
245000004, 45, 4, 0, 0, 1, 0, 0, 0, 0
145000007, 45, 7, 0, 1, 0, 1, 32855, 27235, 5620
145000006, 45, 6, 0, 1, 0, 1, 32895, 16335, 16560
245000004, 45, 4, 0, 0, 1, 0, 0, 0, 0
245000005, 45, 5, 0, 0, 1, 0, 0, 0, 0
145000007, 45, 7, 0, 1, 0, 1, 32975, 27335, 5640
145000006, 45, 6, 0, 1, 0, 1, 33015, 16435, 16580
245000005, 45, 5, 0, 0, 1, 0, 0, 0, 0
145000007, 45, 7, 0, 1, 0, 1, 33095, 27435, 5660
145000005, 45, 5, 0, 1, 0, 1, 33135, 26835, 6300
245000004, 45, 4, 0, 0, 1, 0, 0, 0, 0
245000005, 45, 5, 0, 0, 1, 0, 0, 0, 0
145000007, 45, 7, 0, 1, 0, 1, 33215, 27535, 5680
145000006, 45, 6, 0, 1, 0, 1, 33255, 16535, 16720
245000005, 45, 5, 0, 0, 1, 0, 0, 0, 0
145000007, 45, 7, 0, 1, 0, 1, 33335, 27635, 5700
145000004, 45, 4, 0, 1, 0, 1, 33375, 24835, 8540
245000004, 45, 4, 0, 0, 1, 0, 0, 0, 0
145000007, 45, 7, 0, 1, 0, 1, 33455, 27735, 5720
145000006, 45, 6, 0, 1, 0, 1, 33495, 16635, 16860
245000004, 45, 4, 0, 0, 1, 0, 0, 0, 0
245000005, 45, 5, 0, 0, 1, 0, 0, 0, 0
145000007, 45, 7, 0, 1, 0, 1, 33575, 27835, 5740
145000006, 45, 6, 0, 1, 0, 1, 33615, 16735, 16880
245000005, 45, 5, 0, 0, 1, 0, 0, 0, 0
145000007, 45, 7, 0, 1, 0, 1, 33695, 27935, 5760
145000005, 45, 5, 0, 1, 0, 1, 33735, 27335, 6400
245000004, 45, 4, 0, 0, 1, 0, 0, 0, 0
245000005, 45, 5, 0, 0, 1, 0, 0, 0, 0
145000007, 45, 7, 0, 1, 0, 1, 33815, 28035, 5780
145000006, 45, 6, 0, 1, 0, 1, 33855, 16835, 17020
245000005, 45, 5, 0, 0, 1, 0, 0, 0, 0
145000007, 45, 7, 0, 1, 0, 1, 33935, 28135, 5800
145000004, 45, 4, 0, 1, 0, 1, 33975, 25315, 8660
245000004, 45, 4, 0, 0, 1, 0, 0, 0, 0
145000007, 45, 7, 0, 1, 0, 1, 34055, 28235, 5820
145000006, 45, 6, 0, 1, 0, 1, 34095, 16935, 17160
245000004, 45, 4, 0, 0, 1, 0, 0, 0, 0
245000005, 45, 5, 0, 0, 1, 0, 0, 0, 0
145000007, 45, 7, 0, 1, 0, 1, 34175, 28335, 5840
145000006, 45, 6, 0, 1, 0, 1, 34215, 17035, 17180
245000005, 45, 5, 0, 0, 1, 0, 0, 0, 0
145000007, 45, 7, 0, 1, 0, 1, 34295, 28435, 5860
145000005, 45, 5, 0, 1, 0, 1, 34335, 27835, 6500
245000004, 45, 4, 0, 0, 1, 0, 0, 0, 0
245000005, 45, 5, 0, 0, 1, 0, 0, 0, 0
145000007, 45, 7, 0, 1, 0, 1, 34415, 28535, 5880
145000006, 45, 6, 0, 1, 0, 1, 34455, 17135, 17320
245000005, 45, 5, 0, 0, 1, 0, 0, 0, 0
145000007, 45, 7, 0, 1, 0, 1, 34535, 28635, 5900
145000004, 45, 4, 0, 1, 0, 1, 34575, 25795, 8780
245000004, 45, 4, 0, 0, 1, 0, 0, 0, 0
145000007, 45, 7, 0, 1, 0, 1, 34655, 28735, 5920
145000006, 45, 6, 0, 1, 0, 1, 34695, 17235, 17460
245000004, 45, 4, 0, 0, 1, 0, 0, 0, 0
245000005, 45, 5, 0, 0, 1, 0, 0, 0, 0
145000007, 45, 7, 0, 1, 0, 1, 34775, 28835, 5940
145000006, 45, 6, 0, 1, 0, 1, 34815, 17335, 17480
245000005, 45, 5, 0, 0, 1, 0, 0, 0, 0
145000007, 45, 7, 0, 1, 0, 1, 34895, 28935, 5960
145000005, 45, 5, 0, 1, 0, 1, 34935, 28335, 6600
245000004, 45, 4, 0, 0, 1, 0, 0, 0, 0
245000005, 45, 5, 0, 0, 1, 0, 0, 0, 0
145000007, 45, 7, 0, 1, 0, 1, 35015, 29035, 5980
145000006, 45, 6, 0, 1, 0, 1, 35055, 17435, 17620
245000005, 45, 5, 0, 0, 1, 0, 0, 0, 0
145000007, 45, 7, 0, 1, 0, 1, 35135, 29135, 6000
145000004, 45, 4, 0, 1, 0, 1, 35175, 26275, 8900
245000004, 45, 4, 0, 0, 1, 0, 0, 0, 0
145000007, 45, 7, 0, 1, 0, 1, 35255, 29235, 6020
145000006, 45, 6, 0, 1, 0, 1, 35295, 17535, 17760
245000004, 45, 4, 0, 0, 1, 0, 0, 0, 0
245000005, 45, 5, 0, 0, 1, 0, 0, 0, 0
145000007, 45, 7, 0, 1, 0, 1, 35375, 29335, 6040
145000006, 45, 6, 0, 1, 0, 1, 35415, 17635, 17780
245000005, 45, 5, 0, 0, 1, 0, 0, 0, 0
145000007, 45, 7, 0, 1, 0, 1, 35495, 29435, 6060
145000005, 45, 5, 0, 1, 0, 1, 35535, 28835, 6700
245000004, 45, 4, 0, 0, 1, 0, 0, 0, 0
245000005, 45, 5, 0, 0, 1, 0, 0, 0, 0
145000007, 45, 7, 0, 1, 0, 1, 35615, 29535, 6080
145000006, 45, 6, 0, 1, 0, 1, 35655, 17735, 17920
245000005, 45, 5, 0, 0, 1, 0, 0, 0, 0
145000007, 45, 7, 0, 1, 0, 1, 35735, 29635, 6100
145000004, 45, 4, 0, 1, 0, 1, 35775, 26755, 9020
245000004, 45, 4, 0, 0, 1, 0, 0, 0, 0
145000007, 45, 7, 0, 1, 0, 1, 35855, 29735, 6120
145000006, 45, 6, 0, 1, 0, 1, 35895, 17835, 18060
245000004, 45, 4, 0, 0, 1, 0, 0, 0, 0
245000005, 45, 5, 0, 0, 1, 0, 0, 0, 0
145000007, 45, 7, 0, 1, 0, 1, 35975, 29835, 6140
145000006, 45, 6, 0, 1, 0, 1, 36015, 17935, 18080
245000005, 45, 5, 0, 0, 1, 0, 0, 0, 0
145000007, 45, 7, 0, 1, 0, 1, 36095, 29935, 6160
145000005, 45, 5, 0, 1, 0, 1, 36135, 29335, 6800
245000004, 45, 4, 0, 0, 1, 0, 0, 0, 0
245000005, 45, 5, 0, 0, 1, 0, 0, 0, 0
145000007, 45, 7, 0, 1, 0, 1, 36215, 30035, 6180
145000006, 45, 6, 0, 1, 0, 1, 36255, 18035, 18220
245000005, 45, 5, 0, 0, 1, 0, 0, 0, 0
145000007, 45, 7, 0, 1, 0, 1, 36335, 30135, 6200
145000004, 45, 4, 0, 1, 0, 1, 36375, 27235, 9140
245000004, 45, 4, 0, 0, 1, 0, 0, 0, 0
145000007, 45, 7, 0, 1, 0, 1, 36455, 30235, 6220
145000006, 45, 6, 0, 1, 0, 1, 36495, 18135, 18360
245000004, 45, 4, 0, 0, 1, 0, 0, 0, 0
245000005, 45, 5, 0, 0, 1, 0, 0, 0, 0
145000007, 45, 7, 0, 1, 0, 1, 36575, 30335, 6240
145000006, 45, 6, 0, 1, 0, 1, 36615, 18235, 18380
245000005, 45, 5, 0, 0, 1, 0, 0, 0, 0
145000007, 45, 7, 0, 1, 0, 1, 36695, 30435, 6260
145000005, 45, 5, 0, 1, 0, 1, 36735, 29835, 6900
245000004, 45, 4, 0, 0, 1, 0, 0, 0, 0
245000005, 45, 5, 0, 0, 1, 0, 0, 0, 0
145000007, 45, 7, 0, 1, 0, 1, 36815, 30535, 6280
145000006, 45, 6, 0, 1, 0, 1, 36855, 18335, 18520
245000005, 45, 5, 0, 0, 1, 0, 0, 0, 0
145000007, 45, 7, 0, 1, 0, 1, 36935, 30635, 6300
145000004, 45, 4, 0, 1, 0, 1, 36975, 27715, 9260
245000004, 45, 4, 0, 0, 1, 0, 0, 0, 0
145000007, 45, 7, 0, 1, 0, 1, 37055, 30735, 6320
145000006, 45, 6, 0, 1, 0, 1, 37095, 18435, 18660
245000004, 45, 4, 0, 0, 1, 0, 0, 0, 0
245000005, 45, 5, 0, 0, 1, 0, 0, 0, 0
145000007, 45, 7, 0, 1, 0, 1, 37175, 30835, 6340
145000006, 45, 6, 0, 1, 0, 1, 37215, 18535, 18680
245000005, 45, 5, 0, 0, 1, 0, 0, 0, 0
145000007, 45, 7, 0, 1, 0, 1, 37295, 30935, 6360
145000005, 45, 5, 0, 1, 0, 1, 37335, 30335, 7000
245000004, 45, 4, 0, 0, 1, 0, 0, 0, 0
245000005, 45, 5, 0, 0, 1, 0, 0, 0, 0
145000007, 45, 7, 0, 1, 0, 1, 37415, 31035, 6380
145000006, 45, 6, 0, 1, 0, 1, 37455, 18635, 18820
245000005, 45, 5, 0, 0, 1, 0, 0, 0, 0
145000007, 45, 7, 0, 1, 0, 1, 37535, 31135, 6400
145000004, 45, 4, 0, 1, 0, 1, 37575, 28195, 9380
245000004, 45, 4, 0, 0, 1, 0, 0, 0, 0
145000007, 45, 7, 0, 1, 0, 1, 37655, 31235, 6420
145000006, 45, 6, 0, 1, 0, 1, 37695, 18735, 18960
245000004, 45, 4, 0, 0, 1, 0, 0, 0, 0
245000005, 45, 5, 0, 0, 1, 0, 0, 0, 0
145000007, 45, 7, 0, 1, 0, 1, 37775, 31335, 6440
145000006, 45, 6, 0, 1, 0, 1, 37815, 18835, 18980
245000005, 45, 5, 0, 0, 1, 0, 0, 0, 0
145000007, 45, 7, 0, 1, 0, 1, 37895, 31435, 6460
145000005, 45, 5, 0, 1, 0, 1, 37935, 30835, 7100
245000004, 45, 4, 0, 0, 1, 0, 0, 0, 0
245000005, 45, 5, 0, 0, 1, 0, 0, 0, 0
145000007, 45, 7, 0, 1, 0, 1, 38015, 31535, 6480
145000006, 45, 6, 0, 1, 0, 1, 38055, 18935, 19120
245000005, 45, 5, 0, 0, 1, 0, 0, 0, 0
145000007, 45, 7, 0, 1, 0, 1, 38135, 31635, 6500
145000004, 45, 4, 0, 1, 0, 1, 38175, 28675, 9500
245000004, 45, 4, 0, 0, 1, 0, 0, 0, 0
145000007, 45, 7, 0, 1, 0, 1, 38255, 31735, 6520
145000006, 45, 6, 0, 1, 0, 1, 38295, 19035, 19260
245000004, 45, 4, 0, 0, 1, 0, 0, 0, 0
245000005, 45, 5, 0, 0, 1, 0, 0, 0, 0
145000007, 45, 7, 0, 1, 0, 1, 38375, 31835, 6540
145000006, 45, 6, 0, 1, 0, 1, 38415, 19135, 19280
245000005, 45, 5, 0, 0, 1, 0, 0, 0, 0
145000007, 45, 7, 0, 1, 0, 1, 38495, 31935, 6560
145000005, 45, 5, 0, 1, 0, 1, 38535, 31335, 7200
245000004, 45, 4, 0, 0, 1, 0, 0, 0, 0
245000005, 45, 5, 0, 0, 1, 0, 0, 0, 0
145000007, 45, 7, 0, 1, 0, 1, 38615, 32035, 6580
145000006, 45, 6, 0, 1, 0, 1, 38655, 19235, 19420
245000005, 45, 5, 0, 0, 1, 0, 0, 0, 0
145000007, 45, 7, 0, 1, 0, 1, 38735, 32135, 6600
145000004, 45, 4, 0, 1, 0, 1, 38775, 29155, 9620
245000004, 45, 4, 0, 0, 1, 0, 0, 0, 0
145000007, 45, 7, 0, 1, 0, 1, 38855, 32235, 6620
145000006, 45, 6, 0, 1, 0, 1, 38895, 19335, 19560
245000004, 45, 4, 0, 0, 1, 0, 0, 0, 0
245000005, 45, 5, 0, 0, 1, 0, 0, 0, 0
145000007, 45, 7, 0, 1, 0, 1, 38975, 32335, 6640
145000006, 45, 6, 0, 1, 0, 1, 39015, 19435, 19580
245000005, 45, 5, 0, 0, 1, 0, 0, 0, 0
145000007, 45, 7, 0, 1, 0, 1, 39095, 32435, 6660
145000005, 45, 5, 0, 1, 0, 1, 39135, 31835, 7300
245000004, 45, 4, 0, 0, 1, 0, 0, 0, 0
245000005, 45, 5, 0, 0, 1, 0, 0, 0, 0
145000007, 45, 7, 0, 1, 0, 1, 39215, 32535, 6680
145000006, 45, 6, 0, 1, 0, 1, 39255, 19535, 19720
245000005, 45, 5, 0, 0, 1, 0, 0, 0, 0
145000007, 45, 7, 0, 1, 0, 1, 39335, 32635, 6700
145000004, 45, 4, 0, 1, 0, 1, 39375, 29635, 9740
245000004, 45, 4, 0, 0, 1, 0, 0, 0, 0
145000007, 45, 7, 0, 1, 0, 1, 39455, 32735, 6720
145000006, 45, 6, 0, 1, 0, 1, 39495, 19635, 19860
245000004, 45, 4, 0, 0, 1, 0, 0, 0, 0
245000005, 45, 5, 0, 0, 1, 0, 0, 0, 0
145000007, 45, 7, 0, 1, 0, 1, 39575, 32835, 6740
145000006, 45, 6, 0, 1, 0, 1, 39615, 19735, 19880
245000005, 45, 5, 0, 0, 1, 0, 0, 0, 0
145000007, 45, 7, 0, 1, 0, 1, 39695, 32935, 6760
145000005, 45, 5, 0, 1, 0, 1, 39735, 32335, 7400
245000004, 45, 4, 0, 0, 1, 0, 0, 0, 0
245000005, 45, 5, 0, 0, 1, 0, 0, 0, 0
145000007, 45, 7, 0, 1, 0, 1, 39815, 33035, 6780
145000006, 45, 6, 0, 1, 0, 1, 39855, 19835, 20020
245000005, 45, 5, 0, 0, 1, 0, 0, 0, 0
145000007, 45, 7, 0, 1, 0, 1, 39935, 33135, 6800
145000004, 45, 4, 0, 1, 0, 1, 39975, 30115, 9860
245000004, 45, 4, 0, 0, 1, 0, 0, 0, 0
145000007, 45, 7, 0, 1, 0, 1, 40055, 33235, 6820
145000006, 45, 6, 0, 1, 0, 1, 40095, 19935, 20160
245000004, 45, 4, 0, 0, 1, 0, 0, 0, 0
245000005, 45, 5, 0, 0, 1, 0, 0, 0, 0
145000007, 45, 7, 0, 1, 0, 1, 40175, 33335, 6840
145000006, 45, 6, 0, 1, 0, 1, 40215, 20035, 20180
245000005, 45, 5, 0, 0, 1, 0, 0, 0, 0
145000007, 45, 7, 0, 1, 0, 1, 40295, 33435, 6860
145000005, 45, 5, 0, 1, 0, 1, 40335, 32835, 7500
245000005, 45, 5, 0, 0, 1, 0, 0, 0, 0
145000007, 45, 7, 0, 1, 0, 1, 40415, 33535, 6880
145000006, 45, 6, 0, 1, 0, 1, 40455, 20135, 20320
245000005, 45, 5, 0, 0, 1, 0, 0, 0, 0
145000007, 45, 7, 0, 1, 0, 1, 40535, 33635, 6900
145000004, 45, 4, 0, 1, 0, 1, 40575, 30475, 10100
245000005, 45, 5, 0, 0, 1, 0, 0, 0, 0
145000007, 45, 7, 0, 1, 0, 1, 40655, 33735, 6920
145000006, 45, 6, 0, 1, 0, 1, 40695, 20235, 20460
245000004, 45, 4, 0, 0, 1, 0, 0, 0, 0
145000007, 45, 7, 0, 1, 0, 1, 40775, 33835, 6940
145000006, 45, 6, 0, 1, 0, 1, 40815, 20335, 20480
245000004, 45, 4, 0, 0, 1, 0, 0, 0, 0
245000005, 45, 5, 0, 0, 1, 0, 0, 0, 0
145000007, 45, 7, 0, 1, 0, 1, 40895, 33935, 6960
145000005, 45, 5, 0, 1, 0, 1, 40935, 33335, 7600
245000005, 45, 5, 0, 0, 1, 0, 0, 0, 0
145000007, 45, 7, 0, 1, 0, 1, 41015, 34035, 6980
145000005, 45, 5, 0, 1, 0, 1, 41055, 33535, 7520
245000005, 45, 5, 0, 0, 1, 0, 0, 0, 0
145000007, 45, 7, 0, 1, 0, 1, 41135, 34135, 7000
145000005, 45, 5, 0, 1, 0, 1, 41175, 33735, 7440
145000005, 45, 5, 0, 1, 0, 1, 41275, 33835, 7440
145000004, 45, 4, 0, 1, 0, 1, 41375, 30835, 10540
145000004, 45, 4, 0, 1, 0, 1, 41475, 30955, 10520
145000005, 45, 5, 0, 1, 0, 1, 41575, 33935, 7640
145000005, 45, 5, 0, 1, 0, 1, 41675, 34035, 7640
145000005, 45, 5, 0, 1, 0, 1, 41775, 34135, 7640
145000005, 45, 5, 0, 1, 0, 1, 41875, 34235, 7640
145000004, 45, 4, 0, 1, 0, 1, 41975, 31075, 10900
145000005, 45, 5, 0, 1, 0, 1, 42075, 34335, 7740
145000004, 45, 4, 0, 1, 0, 1, 42175, 31195, 10980
145000005, 45, 5, 0, 1, 0, 1, 42275, 34435, 7840
145000004, 45, 4, 0, 1, 0, 1, 42375, 31315, 11060
145000005, 45, 5, 0, 1, 0, 1, 42475, 34535, 7940
145000003, 45, 3, 0, 1, 0, 1, 42575, 615, 41960
145000004, 45, 4, 0, 1, 0, 1, 42675, 31435, 11240
145000003, 45, 3, 0, 1, 0, 1, 42775, 735, 42040
145000004, 45, 4, 0, 1, 0, 1, 42875, 31555, 11320
145000003, 45, 3, 0, 1, 0, 1, 42975, 855, 42120
145000004, 45, 4, 0, 1, 0, 1, 43075, 31675, 11400
145000002, 45, 2, 0, 1, 0, 1, 43175, 635, 42540
145000004, 45, 4, 0, 1, 0, 1, 43275, 31795, 11480
145000002, 45, 2, 0, 1, 0, 1, 43375, 755, 42620
145000004, 45, 4, 0, 1, 0, 1, 43475, 31915, 11560
145000002, 45, 2, 0, 1, 0, 1, 43575, 875, 42700
145000004, 45, 4, 0, 1, 0, 1, 43675, 32035, 11640
145000002, 45, 2, 0, 1, 0, 1, 43775, 995, 42780
145000001, 45, 1, 0, 1, 0, 1, 43875, 455, 43420
145000004, 45, 4, 0, 1, 0, 1, 43975, 32155, 11820
145000001, 45, 1, 0, 1, 0, 1, 44075, 575, 43500
145000004, 45, 4, 0, 1, 0, 1, 44175, 32275, 11900
145000001, 45, 1, 0, 1, 0, 1, 44275, 695, 43580
145000004, 45, 4, 0, 1, 0, 1, 44375, 32395, 11980
145000001, 45, 1, 0, 1, 0, 1, 44475, 815, 43660
145000004, 45, 4, 0, 1, 0, 1, 44575, 32515, 12060
145000000, 45, 0, 0, 1, 0, 1, 44675, 515, 44160
145000004, 45, 4, 0, 1, 0, 1, 44775, 32635, 12140
145000000, 45, 0, 0, 1, 0, 1, 44875, 635, 44240
145000004, 45, 4, 0, 1, 0, 1, 44975, 32755, 12220
145000000, 45, 0, 0, 1, 0, 1, 45075, 755, 44320
145000004, 45, 4, 0, 1, 0, 1, 45175, 32875, 12300
145000000, 45, 0, 0, 1, 0, 1, 45275, 875, 44400
