Dato,Destino,Fuente,Reset,Valido,Overflow,Completado,Escritura,Lectura,Latencia
5140000000000007, 45, 7, 0, 1, 0, 1, 335, 115, 220
5140000000000003, 45, 3, 0, 1, 0, 1, 375, 135, 240
5140000000000007, 45, 7, 0, 1, 0, 1, 455, 235, 220
9140000000000003, 45, 3, 0, 0, 1, 0, 0, 0, 0
9140000000000003, 45, 3, 0, 0, 1, 0, 0, 0, 0
5140000000000007, 45, 7, 0, 1, 0, 1, 575, 335, 240
9140000000000003, 45, 3, 0, 0, 1, 0, 0, 0, 0
9140000000000003, 45, 3, 0, 0, 1, 0, 0, 0, 0
5140000000000007, 45, 7, 0, 1, 0, 1, 695, 435, 260
9140000000000003, 45, 3, 0, 0, 1, 0, 0, 0, 0
9140000000000003, 45, 3, 0, 0, 1, 0, 0, 0, 0
9140000000000003, 45, 3, 0, 0, 1, 0, 0, 0, 0
5140000000000007, 45, 7, 0, 1, 0, 1, 815, 535, 280
9140000000000003, 45, 3, 0, 0, 1, 0, 0, 0, 0
9140000000000003, 45, 3, 0, 0, 1, 0, 0, 0, 0
5140000000000007, 45, 7, 0, 1, 0, 1, 935, 635, 300
9140000000000005, 45, 5, 0, 0, 1, 0, 0, 0, 0
9140000000000005, 45, 5, 0, 0, 1, 0, 0, 0, 0
5140000000000007, 45, 7, 0, 1, 0, 1, 1055, 735, 320
9140000000000003, 45, 3, 0, 0, 1, 0, 0, 0, 0
9140000000000003, 45, 3, 0, 0, 1, 0, 0, 0, 0
9140000000000003, 45, 3, 0, 0, 1, 0, 0, 0, 0
5140000000000007, 45, 7, 0, 1, 0, 1, 1175, 835, 340
9140000000000003, 45, 3, 0, 0, 1, 0, 0, 0, 0
9140000000000003, 45, 3, 0, 0, 1, 0, 0, 0, 0
5140000000000007, 45, 7, 0, 1, 0, 1, 1295, 935, 360
9140000000000003, 45, 3, 0, 0, 1, 0, 0, 0, 0
9140000000000003, 45, 3, 0, 0, 1, 0, 0, 0, 0
9140000000000003, 45, 3, 0, 0, 1, 0, 0, 0, 0
5140000000000007, 45, 7, 0, 1, 0, 1, 1415, 1035, 380
9140000000000003, 45, 3, 0, 0, 1, 0, 0, 0, 0
9140000000000003, 45, 3, 0, 0, 1, 0, 0, 0, 0
5140000000000007, 45, 7, 0, 1, 0, 1, 1535, 1135, 400
9140000000000005, 45, 5, 0, 0, 1, 0, 0, 0, 0
9140000000000005, 45, 5, 0, 0, 1, 0, 0, 0, 0
5140000000000007, 45, 7, 0, 1, 0, 1, 1655, 1235, 420
9140000000000003, 45, 3, 0, 0, 1, 0, 0, 0, 0
9140000000000003, 45, 3, 0, 0, 1, 0, 0, 0, 0
9140000000000003, 45, 3, 0, 0, 1, 0, 0, 0, 0
5140000000000007, 45, 7, 0, 1, 0, 1, 1775, 1335, 440
9140000000000003, 45, 3, 0, 0, 1, 0, 0, 0, 0
9140000000000003, 45, 3, 0, 0, 1, 0, 0, 0, 0
5140000000000007, 45, 7, 0, 1, 0, 1, 1895, 1435, 460
9140000000000003, 45, 3, 0, 0, 1, 0, 0, 0, 0
9140000000000003, 45, 3, 0, 0, 1, 0, 0, 0, 0
9140000000000003, 45, 3, 0, 0, 1, 0, 0, 0, 0
5140000000000007, 45, 7, 0, 1, 0, 1, 2015, 1535, 480
9140000000000003, 45, 3, 0, 0, 1, 0, 0, 0, 0
9140000000000003, 45, 3, 0, 0, 1, 0, 0, 0, 0
5140000000000007, 45, 7, 0, 1, 0, 1, 2135, 1635, 500
9140000000000005, 45, 5, 0, 0, 1, 0, 0, 0, 0
9140000000000005, 45, 5, 0, 0, 1, 0, 0, 0, 0
5140000000000007, 45, 7, 0, 1, 0, 1, 2255, 1735, 520
9140000000000003, 45, 3, 0, 0, 1, 0, 0, 0, 0
9140000000000003, 45, 3, 0, 0, 1, 0, 0, 0, 0
9140000000000003, 45, 3, 0, 0, 1, 0, 0, 0, 0
5140000000000007, 45, 7, 0, 1, 0, 1, 2375, 1835, 540
9140000000000003, 45, 3, 0, 0, 1, 0, 0, 0, 0
9140000000000003, 45, 3, 0, 0, 1, 0, 0, 0, 0
5140000000000007, 45, 7, 0, 1, 0, 1, 2495, 1935, 560
9140000000000003, 45, 3, 0, 0, 1, 0, 0, 0, 0
9140000000000003, 45, 3, 0, 0, 1, 0, 0, 0, 0
9140000000000003, 45, 3, 0, 0, 1, 0, 0, 0, 0
5140000000000007, 45, 7, 0, 1, 0, 1, 2615, 2035, 580
9140000000000003, 45, 3, 0, 0, 1, 0, 0, 0, 0
9140000000000003, 45, 3, 0, 0, 1, 0, 0, 0, 0
5140000000000007, 45, 7, 0, 1, 0, 1, 2735, 2135, 600
9140000000000005, 45, 5, 0, 0, 1, 0, 0, 0, 0
9140000000000005, 45, 5, 0, 0, 1, 0, 0, 0, 0
5140000000000007, 45, 7, 0, 1, 0, 1, 2855, 2235, 620
9140000000000003, 45, 3, 0, 0, 1, 0, 0, 0, 0
9140000000000003, 45, 3, 0, 0, 1, 0, 0, 0, 0
9140000000000003, 45, 3, 0, 0, 1, 0, 0, 0, 0
5140000000000007, 45, 7, 0, 1, 0, 1, 2975, 2335, 640
9140000000000003, 45, 3, 0, 0, 1, 0, 0, 0, 0
9140000000000003, 45, 3, 0, 0, 1, 0, 0, 0, 0
5140000000000007, 45, 7, 0, 1, 0, 1, 3095, 2435, 660
9140000000000003, 45, 3, 0, 0, 1, 0, 0, 0, 0
9140000000000003, 45, 3, 0, 0, 1, 0, 0, 0, 0
9140000000000003, 45, 3, 0, 0, 1, 0, 0, 0, 0
5140000000000007, 45, 7, 0, 1, 0, 1, 3215, 2535, 680
9140000000000003, 45, 3, 0, 0, 1, 0, 0, 0, 0
9140000000000003, 45, 3, 0, 0, 1, 0, 0, 0, 0
5140000000000007, 45, 7, 0, 1, 0, 1, 3335, 2635, 700
9140000000000005, 45, 5, 0, 0, 1, 0, 0, 0, 0
9140000000000005, 45, 5, 0, 0, 1, 0, 0, 0, 0
5140000000000007, 45, 7, 0, 1, 0, 1, 3455, 2735, 720
9140000000000003, 45, 3, 0, 0, 1, 0, 0, 0, 0
9140000000000003, 45, 3, 0, 0, 1, 0, 0, 0, 0
9140000000000003, 45, 3, 0, 0, 1, 0, 0, 0, 0
5140000000000007, 45, 7, 0, 1, 0, 1, 3575, 2835, 740
9140000000000003, 45, 3, 0, 0, 1, 0, 0, 0, 0
9140000000000003, 45, 3, 0, 0, 1, 0, 0, 0, 0
5140000000000007, 45, 7, 0, 1, 0, 1, 3695, 2935, 760
9140000000000003, 45, 3, 0, 0, 1, 0, 0, 0, 0
9140000000000003, 45, 3, 0, 0, 1, 0, 0, 0, 0
9140000000000003, 45, 3, 0, 0, 1, 0, 0, 0, 0
5140000000000007, 45, 7, 0, 1, 0, 1, 3815, 3035, 780
9140000000000003, 45, 3, 0, 0, 1, 0, 0, 0, 0
9140000000000003, 45, 3, 0, 0, 1, 0, 0, 0, 0
5140000000000007, 45, 7, 0, 1, 0, 1, 3935, 3135, 800
9140000000000005, 45, 5, 0, 0, 1, 0, 0, 0, 0
9140000000000005, 45, 5, 0, 0, 1, 0, 0, 0, 0
5140000000000007, 45, 7, 0, 1, 0, 1, 4055, 3235, 820
9140000000000003, 45, 3, 0, 0, 1, 0, 0, 0, 0
9140000000000003, 45, 3, 0, 0, 1, 0, 0, 0, 0
9140000000000003, 45, 3, 0, 0, 1, 0, 0, 0, 0
5140000000000007, 45, 7, 0, 1, 0, 1, 4175, 3335, 840
9140000000000003, 45, 3, 0, 0, 1, 0, 0, 0, 0
9140000000000003, 45, 3, 0, 0, 1, 0, 0, 0, 0
5140000000000007, 45, 7, 0, 1, 0, 1, 4295, 3435, 860
9140000000000003, 45, 3, 0, 0, 1, 0, 0, 0, 0
9140000000000003, 45, 3, 0, 0, 1, 0, 0, 0, 0
9140000000000003, 45, 3, 0, 0, 1, 0, 0, 0, 0
5140000000000007, 45, 7, 0, 1, 0, 1, 4415, 3535, 880
9140000000000003, 45, 3, 0, 0, 1, 0, 0, 0, 0
9140000000000003, 45, 3, 0, 0, 1, 0, 0, 0, 0
5140000000000007, 45, 7, 0, 1, 0, 1, 4535, 3635, 900
9140000000000005, 45, 5, 0, 0, 1, 0, 0, 0, 0
9140000000000005, 45, 5, 0, 0, 1, 0, 0, 0, 0
5140000000000007, 45, 7, 0, 1, 0, 1, 4655, 3735, 920
9140000000000003, 45, 3, 0, 0, 1, 0, 0, 0, 0
9140000000000003, 45, 3, 0, 0, 1, 0, 0, 0, 0
9140000000000003, 45, 3, 0, 0, 1, 0, 0, 0, 0
5140000000000007, 45, 7, 0, 1, 0, 1, 4775, 3835, 940
9140000000000003, 45, 3, 0, 0, 1, 0, 0, 0, 0
9140000000000003, 45, 3, 0, 0, 1, 0, 0, 0, 0
5140000000000007, 45, 7, 0, 1, 0, 1, 4895, 3935, 960
9140000000000003, 45, 3, 0, 0, 1, 0, 0, 0, 0
9140000000000003, 45, 3, 0, 0, 1, 0, 0, 0, 0
9140000000000003, 45, 3, 0, 0, 1, 0, 0, 0, 0
5140000000000007, 45, 7, 0, 1, 0, 1, 5015, 4035, 980
9140000000000003, 45, 3, 0, 0, 1, 0, 0, 0, 0
9140000000000003, 45, 3, 0, 0, 1, 0, 0, 0, 0
5140000000000007, 45, 7, 0, 1, 0, 1, 5135, 4135, 1000
9140000000000005, 45, 5, 0, 0, 1, 0, 0, 0, 0
9140000000000005, 45, 5, 0, 0, 1, 0, 0, 0, 0
5140000000000007, 45, 7, 0, 1, 0, 1, 5255, 4235, 1020
9140000000000003, 45, 3, 0, 0, 1, 0, 0, 0, 0
9140000000000003, 45, 3, 0, 0, 1, 0, 0, 0, 0
9140000000000003, 45, 3, 0, 0, 1, 0, 0, 0, 0
5140000000000007, 45, 7, 0, 1, 0, 1, 5375, 4335, 1040
9140000000000003, 45, 3, 0, 0, 1, 0, 0, 0, 0
9140000000000003, 45, 3, 0, 0, 1, 0, 0, 0, 0
5140000000000007, 45, 7, 0, 1, 0, 1, 5495, 4435, 1060
9140000000000003, 45, 3, 0, 0, 1, 0, 0, 0, 0
9140000000000003, 45, 3, 0, 0, 1, 0, 0, 0, 0
9140000000000003, 45, 3, 0, 0, 1, 0, 0, 0, 0
5140000000000007, 45, 7, 0, 1, 0, 1, 5615, 4535, 1080
9140000000000003, 45, 3, 0, 0, 1, 0, 0, 0, 0
9140000000000003, 45, 3, 0, 0, 1, 0, 0, 0, 0
5140000000000007, 45, 7, 0, 1, 0, 1, 5735, 4635, 1100
9140000000000005, 45, 5, 0, 0, 1, 0, 0, 0, 0
9140000000000005, 45, 5, 0, 0, 1, 0, 0, 0, 0
5140000000000007, 45, 7, 0, 1, 0, 1, 5855, 4735, 1120
9140000000000003, 45, 3, 0, 0, 1, 0, 0, 0, 0
9140000000000003, 45, 3, 0, 0, 1, 0, 0, 0, 0
9140000000000003, 45, 3, 0, 0, 1, 0, 0, 0, 0
5140000000000007, 45, 7, 0, 1, 0, 1, 5975, 4835, 1140
9140000000000003, 45, 3, 0, 0, 1, 0, 0, 0, 0
9140000000000003, 45, 3, 0, 0, 1, 0, 0, 0, 0
5140000000000007, 45, 7, 0, 1, 0, 1, 6095, 4935, 1160
9140000000000003, 45, 3, 0, 0, 1, 0, 0, 0, 0
9140000000000003, 45, 3, 0, 0, 1, 0, 0, 0, 0
9140000000000003, 45, 3, 0, 0, 1, 0, 0, 0, 0
5140000000000007, 45, 7, 0, 1, 0, 1, 6215, 5035, 1180
9140000000000003, 45, 3, 0, 0, 1, 0, 0, 0, 0
9140000000000003, 45, 3, 0, 0, 1, 0, 0, 0, 0
5140000000000007, 45, 7, 0, 1, 0, 1, 6335, 5135, 1200
9140000000000005, 45, 5, 0, 0, 1, 0, 0, 0, 0
9140000000000005, 45, 5, 0, 0, 1, 0, 0, 0, 0
5140000000000007, 45, 7, 0, 1, 0, 1, 6455, 5235, 1220
9140000000000003, 45, 3, 0, 0, 1, 0, 0, 0, 0
9140000000000003, 45, 3, 0, 0, 1, 0, 0, 0, 0
9140000000000003, 45, 3, 0, 0, 1, 0, 0, 0, 0
5140000000000007, 45, 7, 0, 1, 0, 1, 6575, 5335, 1240
9140000000000003, 45, 3, 0, 0, 1, 0, 0, 0, 0
9140000000000003, 45, 3, 0, 0, 1, 0, 0, 0, 0
5140000000000007, 45, 7, 0, 1, 0, 1, 6695, 5435, 1260
9140000000000003, 45, 3, 0, 0, 1, 0, 0, 0, 0
9140000000000003, 45, 3, 0, 0, 1, 0, 0, 0, 0
9140000000000003, 45, 3, 0, 0, 1, 0, 0, 0, 0
5140000000000007, 45, 7, 0, 1, 0, 1, 6815, 5535, 1280
9140000000000003, 45, 3, 0, 0, 1, 0, 0, 0, 0
9140000000000003, 45, 3, 0, 0, 1, 0, 0, 0, 0
5140000000000007, 45, 7, 0, 1, 0, 1, 6935, 5635, 1300
9140000000000005, 45, 5, 0, 0, 1, 0, 0, 0, 0
9140000000000005, 45, 5, 0, 0, 1, 0, 0, 0, 0
5140000000000007, 45, 7, 0, 1, 0, 1, 7055, 5735, 1320
9140000000000003, 45, 3, 0, 0, 1, 0, 0, 0, 0
9140000000000003, 45, 3, 0, 0, 1, 0, 0, 0, 0
9140000000000003, 45, 3, 0, 0, 1, 0, 0, 0, 0
5140000000000007, 45, 7, 0, 1, 0, 1, 7175, 5835, 1340
9140000000000003, 45, 3, 0, 0, 1, 0, 0, 0, 0
9140000000000003, 45, 3, 0, 0, 1, 0, 0, 0, 0
5140000000000007, 45, 7, 0, 1, 0, 1, 7295, 5935, 1360
9140000000000003, 45, 3, 0, 0, 1, 0, 0, 0, 0
9140000000000003, 45, 3, 0, 0, 1, 0, 0, 0, 0
9140000000000003, 45, 3, 0, 0, 1, 0, 0, 0, 0
5140000000000007, 45, 7, 0, 1, 0, 1, 7415, 6035, 1380
9140000000000003, 45, 3, 0, 0, 1, 0, 0, 0, 0
9140000000000003, 45, 3, 0, 0, 1, 0, 0, 0, 0
5140000000000007, 45, 7, 0, 1, 0, 1, 7535, 6135, 1400
9140000000000005, 45, 5, 0, 0, 1, 0, 0, 0, 0
9140000000000005, 45, 5, 0, 0, 1, 0, 0, 0, 0
5140000000000007, 45, 7, 0, 1, 0, 1, 7655, 6235, 1420
9140000000000003, 45, 3, 0, 0, 1, 0, 0, 0, 0
9140000000000003, 45, 3, 0, 0, 1, 0, 0, 0, 0
9140000000000003, 45, 3, 0, 0, 1, 0, 0, 0, 0
5140000000000007, 45, 7, 0, 1, 0, 1, 7775, 6335, 1440
9140000000000003, 45, 3, 0, 0, 1, 0, 0, 0, 0
9140000000000003, 45, 3, 0, 0, 1, 0, 0, 0, 0
5140000000000007, 45, 7, 0, 1, 0, 1, 7895, 6435, 1460
9140000000000003, 45, 3, 0, 0, 1, 0, 0, 0, 0
9140000000000003, 45, 3, 0, 0, 1, 0, 0, 0, 0
9140000000000003, 45, 3, 0, 0, 1, 0, 0, 0, 0
5140000000000007, 45, 7, 0, 1, 0, 1, 8015, 6535, 1480
9140000000000003, 45, 3, 0, 0, 1, 0, 0, 0, 0
9140000000000003, 45, 3, 0, 0, 1, 0, 0, 0, 0
5140000000000007, 45, 7, 0, 1, 0, 1, 8135, 6635, 1500
9140000000000005, 45, 5, 0, 0, 1, 0, 0, 0, 0
9140000000000005, 45, 5, 0, 0, 1, 0, 0, 0, 0
5140000000000007, 45, 7, 0, 1, 0, 1, 8255, 6735, 1520
9140000000000003, 45, 3, 0, 0, 1, 0, 0, 0, 0
9140000000000003, 45, 3, 0, 0, 1, 0, 0, 0, 0
9140000000000003, 45, 3, 0, 0, 1, 0, 0, 0, 0
5140000000000007, 45, 7, 0, 1, 0, 1, 8375, 6835, 1540
9140000000000003, 45, 3, 0, 0, 1, 0, 0, 0, 0
9140000000000003, 45, 3, 0, 0, 1, 0, 0, 0, 0
5140000000000007, 45, 7, 0, 1, 0, 1, 8495, 6935, 1560
9140000000000003, 45, 3, 0, 0, 1, 0, 0, 0, 0
9140000000000003, 45, 3, 0, 0, 1, 0, 0, 0, 0
9140000000000003, 45, 3, 0, 0, 1, 0, 0, 0, 0
5140000000000007, 45, 7, 0, 1, 0, 1, 8615, 7035, 1580
9140000000000003, 45, 3, 0, 0, 1, 0, 0, 0, 0
9140000000000003, 45, 3, 0, 0, 1, 0, 0, 0, 0
5140000000000007, 45, 7, 0, 1, 0, 1, 8735, 7135, 1600
9140000000000005, 45, 5, 0, 0, 1, 0, 0, 0, 0
9140000000000005, 45, 5, 0, 0, 1, 0, 0, 0, 0
5140000000000007, 45, 7, 0, 1, 0, 1, 8855, 7235, 1620
9140000000000003, 45, 3, 0, 0, 1, 0, 0, 0, 0
9140000000000003, 45, 3, 0, 0, 1, 0, 0, 0, 0
9140000000000003, 45, 3, 0, 0, 1, 0, 0, 0, 0
5140000000000007, 45, 7, 0, 1, 0, 1, 8975, 7335, 1640
9140000000000003, 45, 3, 0, 0, 1, 0, 0, 0, 0
9140000000000003, 45, 3, 0, 0, 1, 0, 0, 0, 0
5140000000000007, 45, 7, 0, 1, 0, 1, 9095, 7435, 1660
9140000000000003, 45, 3, 0, 0, 1, 0, 0, 0, 0
9140000000000003, 45, 3, 0, 0, 1, 0, 0, 0, 0
9140000000000003, 45, 3, 0, 0, 1, 0, 0, 0, 0
5140000000000007, 45, 7, 0, 1, 0, 1, 9215, 7535, 1680
9140000000000003, 45, 3, 0, 0, 1, 0, 0, 0, 0
9140000000000003, 45, 3, 0, 0, 1, 0, 0, 0, 0
5140000000000007, 45, 7, 0, 1, 0, 1, 9335, 7635, 1700
9140000000000005, 45, 5, 0, 0, 1, 0, 0, 0, 0
9140000000000005, 45, 5, 0, 0, 1, 0, 0, 0, 0
5140000000000007, 45, 7, 0, 1, 0, 1, 9455, 7735, 1720
9140000000000003, 45, 3, 0, 0, 1, 0, 0, 0, 0
9140000000000003, 45, 3, 0, 0, 1, 0, 0, 0, 0
9140000000000003, 45, 3, 0, 0, 1, 0, 0, 0, 0
5140000000000007, 45, 7, 0, 1, 0, 1, 9575, 7835, 1740
9140000000000003, 45, 3, 0, 0, 1, 0, 0, 0, 0
9140000000000003, 45, 3, 0, 0, 1, 0, 0, 0, 0
5140000000000007, 45, 7, 0, 1, 0, 1, 9695, 7935, 1760
9140000000000003, 45, 3, 0, 0, 1, 0, 0, 0, 0
9140000000000003, 45, 3, 0, 0, 1, 0, 0, 0, 0
9140000000000003, 45, 3, 0, 0, 1, 0, 0, 0, 0
5140000000000007, 45, 7, 0, 1, 0, 1, 9815, 8035, 1780
9140000000000003, 45, 3, 0, 0, 1, 0, 0, 0, 0
9140000000000003, 45, 3, 0, 0, 1, 0, 0, 0, 0
5140000000000007, 45, 7, 0, 1, 0, 1, 9935, 8135, 1800
9140000000000005, 45, 5, 0, 0, 1, 0, 0, 0, 0
9140000000000005, 45, 5, 0, 0, 1, 0, 0, 0, 0
5140000000000007, 45, 7, 0, 1, 0, 1, 10055, 8235, 1820
9140000000000003, 45, 3, 0, 0, 1, 0, 0, 0, 0
9140000000000003, 45, 3, 0, 0, 1, 0, 0, 0, 0
9140000000000003, 45, 3, 0, 0, 1, 0, 0, 0, 0
5140000000000007, 45, 7, 0, 1, 0, 1, 10175, 8335, 1840
9140000000000003, 45, 3, 0, 0, 1, 0, 0, 0, 0
9140000000000003, 45, 3, 0, 0, 1, 0, 0, 0, 0
5140000000000007, 45, 7, 0, 1, 0, 1, 10295, 8435, 1860
9140000000000003, 45, 3, 0, 0, 1, 0, 0, 0, 0
9140000000000003, 45, 3, 0, 0, 1, 0, 0, 0, 0
9140000000000003, 45, 3, 0, 0, 1, 0, 0, 0, 0
5140000000000007, 45, 7, 0, 1, 0, 1, 10415, 8535, 1880
9140000000000003, 45, 3, 0, 0, 1, 0, 0, 0, 0
9140000000000003, 45, 3, 0, 0, 1, 0, 0, 0, 0
5140000000000007, 45, 7, 0, 1, 0, 1, 10535, 8635, 1900
9140000000000005, 45, 5, 0, 0, 1, 0, 0, 0, 0
9140000000000005, 45, 5, 0, 0, 1, 0, 0, 0, 0
5140000000000007, 45, 7, 0, 1, 0, 1, 10655, 8735, 1920
9140000000000003, 45, 3, 0, 0, 1, 0, 0, 0, 0
9140000000000003, 45, 3, 0, 0, 1, 0, 0, 0, 0
9140000000000003, 45, 3, 0, 0, 1, 0, 0, 0, 0
5140000000000007, 45, 7, 0, 1, 0, 1, 10775, 8835, 1940
9140000000000003, 45, 3, 0, 0, 1, 0, 0, 0, 0
9140000000000003, 45, 3, 0, 0, 1, 0, 0, 0, 0
5140000000000007, 45, 7, 0, 1, 0, 1, 10895, 8935, 1960
9140000000000003, 45, 3, 0, 0, 1, 0, 0, 0, 0
9140000000000003, 45, 3, 0, 0, 1, 0, 0, 0, 0
9140000000000003, 45, 3, 0, 0, 1, 0, 0, 0, 0
5140000000000007, 45, 7, 0, 1, 0, 1, 11015, 9035, 1980
9140000000000003, 45, 3, 0, 0, 1, 0, 0, 0, 0
9140000000000003, 45, 3, 0, 0, 1, 0, 0, 0, 0
5140000000000007, 45, 7, 0, 1, 0, 1, 11135, 9135, 2000
9140000000000005, 45, 5, 0, 0, 1, 0, 0, 0, 0
9140000000000005, 45, 5, 0, 0, 1, 0, 0, 0, 0
5140000000000007, 45, 7, 0, 1, 0, 1, 11255, 9235, 2020
9140000000000003, 45, 3, 0, 0, 1, 0, 0, 0, 0
9140000000000003, 45, 3, 0, 0, 1, 0, 0, 0, 0
9140000000000003, 45, 3, 0, 0, 1, 0, 0, 0, 0
5140000000000007, 45, 7, 0, 1, 0, 1, 11375, 9335, 2040
9140000000000003, 45, 3, 0, 0, 1, 0, 0, 0, 0
9140000000000003, 45, 3, 0, 0, 1, 0, 0, 0, 0
5140000000000007, 45, 7, 0, 1, 0, 1, 11495, 9435, 2060
9140000000000003, 45, 3, 0, 0, 1, 0, 0, 0, 0
9140000000000003, 45, 3, 0, 0, 1, 0, 0, 0, 0
9140000000000003, 45, 3, 0, 0, 1, 0, 0, 0, 0
5140000000000007, 45, 7, 0, 1, 0, 1, 11615, 9535, 2080
9140000000000003, 45, 3, 0, 0, 1, 0, 0, 0, 0
9140000000000003, 45, 3, 0, 0, 1, 0, 0, 0, 0
5140000000000007, 45, 7, 0, 1, 0, 1, 11735, 9635, 2100
9140000000000005, 45, 5, 0, 0, 1, 0, 0, 0, 0
9140000000000005, 45, 5, 0, 0, 1, 0, 0, 0, 0
5140000000000007, 45, 7, 0, 1, 0, 1, 11855, 9735, 2120
9140000000000003, 45, 3, 0, 0, 1, 0, 0, 0, 0
9140000000000003, 45, 3, 0, 0, 1, 0, 0, 0, 0
9140000000000003, 45, 3, 0, 0, 1, 0, 0, 0, 0
5140000000000007, 45, 7, 0, 1, 0, 1, 11975, 9835, 2140
9140000000000003, 45, 3, 0, 0, 1, 0, 0, 0, 0
9140000000000003, 45, 3, 0, 0, 1, 0, 0, 0, 0
5140000000000007, 45, 7, 0, 1, 0, 1, 12095, 9935, 2160
9140000000000003, 45, 3, 0, 0, 1, 0, 0, 0, 0
9140000000000003, 45, 3, 0, 0, 1, 0, 0, 0, 0
9140000000000003, 45, 3, 0, 0, 1, 0, 0, 0, 0
5140000000000007, 45, 7, 0, 1, 0, 1, 12215, 10035, 2180
9140000000000003, 45, 3, 0, 0, 1, 0, 0, 0, 0
9140000000000003, 45, 3, 0, 0, 1, 0, 0, 0, 0
5140000000000007, 45, 7, 0, 1, 0, 1, 12335, 10135, 2200
9140000000000005, 45, 5, 0, 0, 1, 0, 0, 0, 0
9140000000000005, 45, 5, 0, 0, 1, 0, 0, 0, 0
5140000000000007, 45, 7, 0, 1, 0, 1, 12455, 10235, 2220
9140000000000003, 45, 3, 0, 0, 1, 0, 0, 0, 0
9140000000000003, 45, 3, 0, 0, 1, 0, 0, 0, 0
9140000000000003, 45, 3, 0, 0, 1, 0, 0, 0, 0
5140000000000007, 45, 7, 0, 1, 0, 1, 12575, 10335, 2240
9140000000000003, 45, 3, 0, 0, 1, 0, 0, 0, 0
9140000000000003, 45, 3, 0, 0, 1, 0, 0, 0, 0
5140000000000007, 45, 7, 0, 1, 0, 1, 12695, 10435, 2260
9140000000000003, 45, 3, 0, 0, 1, 0, 0, 0, 0
9140000000000003, 45, 3, 0, 0, 1, 0, 0, 0, 0
9140000000000003, 45, 3, 0, 0, 1, 0, 0, 0, 0
5140000000000007, 45, 7, 0, 1, 0, 1, 12815, 10535, 2280
9140000000000003, 45, 3, 0, 0, 1, 0, 0, 0, 0
9140000000000003, 45, 3, 0, 0, 1, 0, 0, 0, 0
5140000000000007, 45, 7, 0, 1, 0, 1, 12935, 10635, 2300
9140000000000005, 45, 5, 0, 0, 1, 0, 0, 0, 0
9140000000000005, 45, 5, 0, 0, 1, 0, 0, 0, 0
5140000000000007, 45, 7, 0, 1, 0, 1, 13055, 10735, 2320
9140000000000003, 45, 3, 0, 0, 1, 0, 0, 0, 0
9140000000000003, 45, 3, 0, 0, 1, 0, 0, 0, 0
9140000000000003, 45, 3, 0, 0, 1, 0, 0, 0, 0
5140000000000007, 45, 7, 0, 1, 0, 1, 13175, 10835, 2340
9140000000000003, 45, 3, 0, 0, 1, 0, 0, 0, 0
9140000000000003, 45, 3, 0, 0, 1, 0, 0, 0, 0
5140000000000007, 45, 7, 0, 1, 0, 1, 13295, 10935, 2360
9140000000000003, 45, 3, 0, 0, 1, 0, 0, 0, 0
9140000000000003, 45, 3, 0, 0, 1, 0, 0, 0, 0
9140000000000003, 45, 3, 0, 0, 1, 0, 0, 0, 0
5140000000000007, 45, 7, 0, 1, 0, 1, 13415, 11035, 2380
9140000000000003, 45, 3, 0, 0, 1, 0, 0, 0, 0
9140000000000003, 45, 3, 0, 0, 1, 0, 0, 0, 0
5140000000000007, 45, 7, 0, 1, 0, 1, 13535, 11135, 2400
9140000000000005, 45, 5, 0, 0, 1, 0, 0, 0, 0
9140000000000005, 45, 5, 0, 0, 1, 0, 0, 0, 0
5140000000000007, 45, 7, 0, 1, 0, 1, 13655, 11235, 2420
9140000000000003, 45, 3, 0, 0, 1, 0, 0, 0, 0
9140000000000003, 45, 3, 0, 0, 1, 0, 0, 0, 0
9140000000000003, 45, 3, 0, 0, 1, 0, 0, 0, 0
5140000000000007, 45, 7, 0, 1, 0, 1, 13775, 11335, 2440
9140000000000003, 45, 3, 0, 0, 1, 0, 0, 0, 0
9140000000000003, 45, 3, 0, 0, 1, 0, 0, 0, 0
5140000000000007, 45, 7, 0, 1, 0, 1, 13895, 11435, 2460
9140000000000003, 45, 3, 0, 0, 1, 0, 0, 0, 0
9140000000000003, 45, 3, 0, 0, 1, 0, 0, 0, 0
9140000000000003, 45, 3, 0, 0, 1, 0, 0, 0, 0
5140000000000007, 45, 7, 0, 1, 0, 1, 14015, 11535, 2480
9140000000000003, 45, 3, 0, 0, 1, 0, 0, 0, 0
9140000000000003, 45, 3, 0, 0, 1, 0, 0, 0, 0
5140000000000007, 45, 7, 0, 1, 0, 1, 14135, 11635, 2500
9140000000000005, 45, 5, 0, 0, 1, 0, 0, 0, 0
9140000000000005, 45, 5, 0, 0, 1, 0, 0, 0, 0
5140000000000007, 45, 7, 0, 1, 0, 1, 14255, 11735, 2520
9140000000000003, 45, 3, 0, 0, 1, 0, 0, 0, 0
9140000000000003, 45, 3, 0, 0, 1, 0, 0, 0, 0
9140000000000003, 45, 3, 0, 0, 1, 0, 0, 0, 0
5140000000000007, 45, 7, 0, 1, 0, 1, 14375, 11835, 2540
9140000000000003, 45, 3, 0, 0, 1, 0, 0, 0, 0
9140000000000003, 45, 3, 0, 0, 1, 0, 0, 0, 0
5140000000000007, 45, 7, 0, 1, 0, 1, 14495, 11935, 2560
9140000000000003, 45, 3, 0, 0, 1, 0, 0, 0, 0
9140000000000003, 45, 3, 0, 0, 1, 0, 0, 0, 0
9140000000000003, 45, 3, 0, 0, 1, 0, 0, 0, 0
5140000000000007, 45, 7, 0, 1, 0, 1, 14615, 12035, 2580
9140000000000003, 45, 3, 0, 0, 1, 0, 0, 0, 0
9140000000000003, 45, 3, 0, 0, 1, 0, 0, 0, 0
5140000000000007, 45, 7, 0, 1, 0, 1, 14735, 12135, 2600
9140000000000005, 45, 5, 0, 0, 1, 0, 0, 0, 0
9140000000000005, 45, 5, 0, 0, 1, 0, 0, 0, 0
5140000000000007, 45, 7, 0, 1, 0, 1, 14855, 12235, 2620
9140000000000003, 45, 3, 0, 0, 1, 0, 0, 0, 0
9140000000000003, 45, 3, 0, 0, 1, 0, 0, 0, 0
9140000000000003, 45, 3, 0, 0, 1, 0, 0, 0, 0
5140000000000007, 45, 7, 0, 1, 0, 1, 14975, 12335, 2640
9140000000000003, 45, 3, 0, 0, 1, 0, 0, 0, 0
9140000000000003, 45, 3, 0, 0, 1, 0, 0, 0, 0
5140000000000007, 45, 7, 0, 1, 0, 1, 15095, 12435, 2660
9140000000000003, 45, 3, 0, 0, 1, 0, 0, 0, 0
9140000000000003, 45, 3, 0, 0, 1, 0, 0, 0, 0
9140000000000003, 45, 3, 0, 0, 1, 0, 0, 0, 0
5140000000000007, 45, 7, 0, 1, 0, 1, 15215, 12535, 2680
9140000000000003, 45, 3, 0, 0, 1, 0, 0, 0, 0
9140000000000003, 45, 3, 0, 0, 1, 0, 0, 0, 0
5140000000000007, 45, 7, 0, 1, 0, 1, 15335, 12635, 2700
9140000000000005, 45, 5, 0, 0, 1, 0, 0, 0, 0
9140000000000005, 45, 5, 0, 0, 1, 0, 0, 0, 0
5140000000000007, 45, 7, 0, 1, 0, 1, 15455, 12735, 2720
9140000000000003, 45, 3, 0, 0, 1, 0, 0, 0, 0
9140000000000003, 45, 3, 0, 0, 1, 0, 0, 0, 0
9140000000000003, 45, 3, 0, 0, 1, 0, 0, 0, 0
5140000000000007, 45, 7, 0, 1, 0, 1, 15575, 12835, 2740
9140000000000003, 45, 3, 0, 0, 1, 0, 0, 0, 0
9140000000000003, 45, 3, 0, 0, 1, 0, 0, 0, 0
5140000000000007, 45, 7, 0, 1, 0, 1, 15695, 12935, 2760
9140000000000003, 45, 3, 0, 0, 1, 0, 0, 0, 0
9140000000000003, 45, 3, 0, 0, 1, 0, 0, 0, 0
9140000000000003, 45, 3, 0, 0, 1, 0, 0, 0, 0
5140000000000007, 45, 7, 0, 1, 0, 1, 15815, 13035, 2780
9140000000000003, 45, 3, 0, 0, 1, 0, 0, 0, 0
9140000000000003, 45, 3, 0, 0, 1, 0, 0, 0, 0
5140000000000007, 45, 7, 0, 1, 0, 1, 15935, 13135, 2800
9140000000000005, 45, 5, 0, 0, 1, 0, 0, 0, 0
9140000000000005, 45, 5, 0, 0, 1, 0, 0, 0, 0
5140000000000007, 45, 7, 0, 1, 0, 1, 16055, 13235, 2820
9140000000000003, 45, 3, 0, 0, 1, 0, 0, 0, 0
9140000000000003, 45, 3, 0, 0, 1, 0, 0, 0, 0
9140000000000003, 45, 3, 0, 0, 1, 0, 0, 0, 0
5140000000000007, 45, 7, 0, 1, 0, 1, 16175, 13335, 2840
9140000000000003, 45, 3, 0, 0, 1, 0, 0, 0, 0
9140000000000003, 45, 3, 0, 0, 1, 0, 0, 0, 0
5140000000000007, 45, 7, 0, 1, 0, 1, 16295, 13435, 2860
9140000000000003, 45, 3, 0, 0, 1, 0, 0, 0, 0
9140000000000003, 45, 3, 0, 0, 1, 0, 0, 0, 0
9140000000000003, 45, 3, 0, 0, 1, 0, 0, 0, 0
5140000000000007, 45, 7, 0, 1, 0, 1, 16415, 13535, 2880
9140000000000003, 45, 3, 0, 0, 1, 0, 0, 0, 0
9140000000000003, 45, 3, 0, 0, 1, 0, 0, 0, 0
5140000000000007, 45, 7, 0, 1, 0, 1, 16535, 13635, 2900
9140000000000005, 45, 5, 0, 0, 1, 0, 0, 0, 0
9140000000000005, 45, 5, 0, 0, 1, 0, 0, 0, 0
5140000000000007, 45, 7, 0, 1, 0, 1, 16655, 13735, 2920
9140000000000003, 45, 3, 0, 0, 1, 0, 0, 0, 0
9140000000000003, 45, 3, 0, 0, 1, 0, 0, 0, 0
9140000000000003, 45, 3, 0, 0, 1, 0, 0, 0, 0
5140000000000007, 45, 7, 0, 1, 0, 1, 16775, 13835, 2940
9140000000000003, 45, 3, 0, 0, 1, 0, 0, 0, 0
9140000000000003, 45, 3, 0, 0, 1, 0, 0, 0, 0
5140000000000007, 45, 7, 0, 1, 0, 1, 16895, 13935, 2960
9140000000000003, 45, 3, 0, 0, 1, 0, 0, 0, 0
9140000000000003, 45, 3, 0, 0, 1, 0, 0, 0, 0
9140000000000003, 45, 3, 0, 0, 1, 0, 0, 0, 0
5140000000000007, 45, 7, 0, 1, 0, 1, 17015, 14035, 2980
9140000000000003, 45, 3, 0, 0, 1, 0, 0, 0, 0
9140000000000003, 45, 3, 0, 0, 1, 0, 0, 0, 0
5140000000000007, 45, 7, 0, 1, 0, 1, 17135, 14135, 3000
9140000000000005, 45, 5, 0, 0, 1, 0, 0, 0, 0
9140000000000005, 45, 5, 0, 0, 1, 0, 0, 0, 0
5140000000000007, 45, 7, 0, 1, 0, 1, 17255, 14235, 3020
9140000000000003, 45, 3, 0, 0, 1, 0, 0, 0, 0
9140000000000003, 45, 3, 0, 0, 1, 0, 0, 0, 0
9140000000000003, 45, 3, 0, 0, 1, 0, 0, 0, 0
5140000000000007, 45, 7, 0, 1, 0, 1, 17375, 14335, 3040
9140000000000003, 45, 3, 0, 0, 1, 0, 0, 0, 0
9140000000000003, 45, 3, 0, 0, 1, 0, 0, 0, 0
5140000000000007, 45, 7, 0, 1, 0, 1, 17495, 14435, 3060
9140000000000003, 45, 3, 0, 0, 1, 0, 0, 0, 0
9140000000000003, 45, 3, 0, 0, 1, 0, 0, 0, 0
9140000000000003, 45, 3, 0, 0, 1, 0, 0, 0, 0
5140000000000007, 45, 7, 0, 1, 0, 1, 17615, 14535, 3080
9140000000000003, 45, 3, 0, 0, 1, 0, 0, 0, 0
9140000000000003, 45, 3, 0, 0, 1, 0, 0, 0, 0
5140000000000007, 45, 7, 0, 1, 0, 1, 17735, 14635, 3100
9140000000000005, 45, 5, 0, 0, 1, 0, 0, 0, 0
9140000000000005, 45, 5, 0, 0, 1, 0, 0, 0, 0
5140000000000007, 45, 7, 0, 1, 0, 1, 17855, 14735, 3120
9140000000000003, 45, 3, 0, 0, 1, 0, 0, 0, 0
9140000000000003, 45, 3, 0, 0, 1, 0, 0, 0, 0
9140000000000003, 45, 3, 0, 0, 1, 0, 0, 0, 0
5140000000000007, 45, 7, 0, 1, 0, 1, 17975, 14835, 3140
9140000000000003, 45, 3, 0, 0, 1, 0, 0, 0, 0
9140000000000003, 45, 3, 0, 0, 1, 0, 0, 0, 0
5140000000000007, 45, 7, 0, 1, 0, 1, 18095, 14935, 3160
9140000000000003, 45, 3, 0, 0, 1, 0, 0, 0, 0
9140000000000003, 45, 3, 0, 0, 1, 0, 0, 0, 0
9140000000000003, 45, 3, 0, 0, 1, 0, 0, 0, 0
5140000000000007, 45, 7, 0, 1, 0, 1, 18215, 15035, 3180
9140000000000003, 45, 3, 0, 0, 1, 0, 0, 0, 0
9140000000000003, 45, 3, 0, 0, 1, 0, 0, 0, 0
5140000000000007, 45, 7, 0, 1, 0, 1, 18335, 15135, 3200
9140000000000005, 45, 5, 0, 0, 1, 0, 0, 0, 0
9140000000000005, 45, 5, 0, 0, 1, 0, 0, 0, 0
5140000000000007, 45, 7, 0, 1, 0, 1, 18455, 15235, 3220
9140000000000003, 45, 3, 0, 0, 1, 0, 0, 0, 0
9140000000000003, 45, 3, 0, 0, 1, 0, 0, 0, 0
9140000000000003, 45, 3, 0, 0, 1, 0, 0, 0, 0
5140000000000007, 45, 7, 0, 1, 0, 1, 18575, 15335, 3240
9140000000000003, 45, 3, 0, 0, 1, 0, 0, 0, 0
9140000000000003, 45, 3, 0, 0, 1, 0, 0, 0, 0
5140000000000007, 45, 7, 0, 1, 0, 1, 18695, 15435, 3260
9140000000000003, 45, 3, 0, 0, 1, 0, 0, 0, 0
9140000000000003, 45, 3, 0, 0, 1, 0, 0, 0, 0
9140000000000003, 45, 3, 0, 0, 1, 0, 0, 0, 0
5140000000000007, 45, 7, 0, 1, 0, 1, 18815, 15535, 3280
9140000000000003, 45, 3, 0, 0, 1, 0, 0, 0, 0
9140000000000003, 45, 3, 0, 0, 1, 0, 0, 0, 0
5140000000000007, 45, 7, 0, 1, 0, 1, 18935, 15635, 3300
9140000000000005, 45, 5, 0, 0, 1, 0, 0, 0, 0
9140000000000005, 45, 5, 0, 0, 1, 0, 0, 0, 0
5140000000000007, 45, 7, 0, 1, 0, 1, 19055, 15735, 3320
9140000000000003, 45, 3, 0, 0, 1, 0, 0, 0, 0
9140000000000003, 45, 3, 0, 0, 1, 0, 0, 0, 0
9140000000000003, 45, 3, 0, 0, 1, 0, 0, 0, 0
5140000000000007, 45, 7, 0, 1, 0, 1, 19175, 15835, 3340
9140000000000003, 45, 3, 0, 0, 1, 0, 0, 0, 0
9140000000000003, 45, 3, 0, 0, 1, 0, 0, 0, 0
5140000000000007, 45, 7, 0, 1, 0, 1, 19295, 15935, 3360
9140000000000003, 45, 3, 0, 0, 1, 0, 0, 0, 0
9140000000000003, 45, 3, 0, 0, 1, 0, 0, 0, 0
9140000000000003, 45, 3, 0, 0, 1, 0, 0, 0, 0
5140000000000007, 45, 7, 0, 1, 0, 1, 19415, 16035, 3380
9140000000000003, 45, 3, 0, 0, 1, 0, 0, 0, 0
9140000000000003, 45, 3, 0, 0, 1, 0, 0, 0, 0
5140000000000007, 45, 7, 0, 1, 0, 1, 19535, 16135, 3400
9140000000000005, 45, 5, 0, 0, 1, 0, 0, 0, 0
9140000000000005, 45, 5, 0, 0, 1, 0, 0, 0, 0
5140000000000007, 45, 7, 0, 1, 0, 1, 19655, 16235, 3420
9140000000000003, 45, 3, 0, 0, 1, 0, 0, 0, 0
9140000000000003, 45, 3, 0, 0, 1, 0, 0, 0, 0
9140000000000003, 45, 3, 0, 0, 1, 0, 0, 0, 0
5140000000000007, 45, 7, 0, 1, 0, 1, 19775, 16335, 3440
9140000000000003, 45, 3, 0, 0, 1, 0, 0, 0, 0
9140000000000003, 45, 3, 0, 0, 1, 0, 0, 0, 0
5140000000000007, 45, 7, 0, 1, 0, 1, 19895, 16435, 3460
9140000000000003, 45, 3, 0, 0, 1, 0, 0, 0, 0
9140000000000003, 45, 3, 0, 0, 1, 0, 0, 0, 0
9140000000000003, 45, 3, 0, 0, 1, 0, 0, 0, 0
5140000000000007, 45, 7, 0, 1, 0, 1, 20015, 16535, 3480
9140000000000003, 45, 3, 0, 0, 1, 0, 0, 0, 0
9140000000000003, 45, 3, 0, 0, 1, 0, 0, 0, 0
5140000000000007, 45, 7, 0, 1, 0, 1, 20135, 16635, 3500
9140000000000005, 45, 5, 0, 0, 1, 0, 0, 0, 0
9140000000000005, 45, 5, 0, 0, 1, 0, 0, 0, 0
5140000000000007, 45, 7, 0, 1, 0, 1, 20255, 16735, 3520
9140000000000003, 45, 3, 0, 0, 1, 0, 0, 0, 0
9140000000000003, 45, 3, 0, 0, 1, 0, 0, 0, 0
9140000000000003, 45, 3, 0, 0, 1, 0, 0, 0, 0
5140000000000007, 45, 7, 0, 1, 0, 1, 20375, 16835, 3540
9140000000000003, 45, 3, 0, 0, 1, 0, 0, 0, 0
9140000000000003, 45, 3, 0, 0, 1, 0, 0, 0, 0
5140000000000007, 45, 7, 0, 1, 0, 1, 20495, 16935, 3560
9140000000000003, 45, 3, 0, 0, 1, 0, 0, 0, 0
9140000000000003, 45, 3, 0, 0, 1, 0, 0, 0, 0
9140000000000003, 45, 3, 0, 0, 1, 0, 0, 0, 0
5140000000000007, 45, 7, 0, 1, 0, 1, 20615, 17035, 3580
9140000000000003, 45, 3, 0, 0, 1, 0, 0, 0, 0
9140000000000003, 45, 3, 0, 0, 1, 0, 0, 0, 0
5140000000000007, 45, 7, 0, 1, 0, 1, 20735, 17135, 3600
9140000000000005, 45, 5, 0, 0, 1, 0, 0, 0, 0
9140000000000005, 45, 5, 0, 0, 1, 0, 0, 0, 0
5140000000000007, 45, 7, 0, 1, 0, 1, 20855, 17235, 3620
9140000000000003, 45, 3, 0, 0, 1, 0, 0, 0, 0
9140000000000003, 45, 3, 0, 0, 1, 0, 0, 0, 0
9140000000000003, 45, 3, 0, 0, 1, 0, 0, 0, 0
5140000000000007, 45, 7, 0, 1, 0, 1, 20975, 17335, 3640
9140000000000003, 45, 3, 0, 0, 1, 0, 0, 0, 0
9140000000000003, 45, 3, 0, 0, 1, 0, 0, 0, 0
5140000000000007, 45, 7, 0, 1, 0, 1, 21095, 17435, 3660
9140000000000003, 45, 3, 0, 0, 1, 0, 0, 0, 0
9140000000000003, 45, 3, 0, 0, 1, 0, 0, 0, 0
9140000000000003, 45, 3, 0, 0, 1, 0, 0, 0, 0
5140000000000007, 45, 7, 0, 1, 0, 1, 21215, 17535, 3680
9140000000000003, 45, 3, 0, 0, 1, 0, 0, 0, 0
9140000000000003, 45, 3, 0, 0, 1, 0, 0, 0, 0
5140000000000007, 45, 7, 0, 1, 0, 1, 21335, 17635, 3700
9140000000000005, 45, 5, 0, 0, 1, 0, 0, 0, 0
9140000000000005, 45, 5, 0, 0, 1, 0, 0, 0, 0
5140000000000007, 45, 7, 0, 1, 0, 1, 21455, 17735, 3720
9140000000000003, 45, 3, 0, 0, 1, 0, 0, 0, 0
9140000000000003, 45, 3, 0, 0, 1, 0, 0, 0, 0
9140000000000003, 45, 3, 0, 0, 1, 0, 0, 0, 0
5140000000000007, 45, 7, 0, 1, 0, 1, 21575, 17835, 3740
9140000000000003, 45, 3, 0, 0, 1, 0, 0, 0, 0
9140000000000003, 45, 3, 0, 0, 1, 0, 0, 0, 0
5140000000000007, 45, 7, 0, 1, 0, 1, 21695, 17935, 3760
9140000000000003, 45, 3, 0, 0, 1, 0, 0, 0, 0
9140000000000003, 45, 3, 0, 0, 1, 0, 0, 0, 0
9140000000000003, 45, 3, 0, 0, 1, 0, 0, 0, 0
5140000000000007, 45, 7, 0, 1, 0, 1, 21815, 18035, 3780
9140000000000003, 45, 3, 0, 0, 1, 0, 0, 0, 0
9140000000000003, 45, 3, 0, 0, 1, 0, 0, 0, 0
5140000000000007, 45, 7, 0, 1, 0, 1, 21935, 18135, 3800
9140000000000005, 45, 5, 0, 0, 1, 0, 0, 0, 0
9140000000000005, 45, 5, 0, 0, 1, 0, 0, 0, 0
5140000000000007, 45, 7, 0, 1, 0, 1, 22055, 18235, 3820
9140000000000003, 45, 3, 0, 0, 1, 0, 0, 0, 0
9140000000000003, 45, 3, 0, 0, 1, 0, 0, 0, 0
9140000000000003, 45, 3, 0, 0, 1, 0, 0, 0, 0
5140000000000007, 45, 7, 0, 1, 0, 1, 22175, 18335, 3840
9140000000000003, 45, 3, 0, 0, 1, 0, 0, 0, 0
9140000000000003, 45, 3, 0, 0, 1, 0, 0, 0, 0
5140000000000007, 45, 7, 0, 1, 0, 1, 22295, 18435, 3860
9140000000000003, 45, 3, 0, 0, 1, 0, 0, 0, 0
9140000000000003, 45, 3, 0, 0, 1, 0, 0, 0, 0
9140000000000003, 45, 3, 0, 0, 1, 0, 0, 0, 0
5140000000000007, 45, 7, 0, 1, 0, 1, 22415, 18535, 3880
9140000000000003, 45, 3, 0, 0, 1, 0, 0, 0, 0
9140000000000003, 45, 3, 0, 0, 1, 0, 0, 0, 0
5140000000000007, 45, 7, 0, 1, 0, 1, 22535, 18635, 3900
9140000000000005, 45, 5, 0, 0, 1, 0, 0, 0, 0
9140000000000005, 45, 5, 0, 0, 1, 0, 0, 0, 0
5140000000000007, 45, 7, 0, 1, 0, 1, 22655, 18735, 3920
9140000000000003, 45, 3, 0, 0, 1, 0, 0, 0, 0
9140000000000003, 45, 3, 0, 0, 1, 0, 0, 0, 0
9140000000000003, 45, 3, 0, 0, 1, 0, 0, 0, 0
5140000000000007, 45, 7, 0, 1, 0, 1, 22775, 18835, 3940
9140000000000003, 45, 3, 0, 0, 1, 0, 0, 0, 0
9140000000000003, 45, 3, 0, 0, 1, 0, 0, 0, 0
5140000000000007, 45, 7, 0, 1, 0, 1, 22895, 18935, 3960
9140000000000003, 45, 3, 0, 0, 1, 0, 0, 0, 0
9140000000000003, 45, 3, 0, 0, 1, 0, 0, 0, 0
9140000000000003, 45, 3, 0, 0, 1, 0, 0, 0, 0
5140000000000007, 45, 7, 0, 1, 0, 1, 23015, 19035, 3980
9140000000000003, 45, 3, 0, 0, 1, 0, 0, 0, 0
9140000000000003, 45, 3, 0, 0, 1, 0, 0, 0, 0
5140000000000007, 45, 7, 0, 1, 0, 1, 23135, 19135, 4000
9140000000000005, 45, 5, 0, 0, 1, 0, 0, 0, 0
9140000000000005, 45, 5, 0, 0, 1, 0, 0, 0, 0
5140000000000007, 45, 7, 0, 1, 0, 1, 23255, 19235, 4020
9140000000000003, 45, 3, 0, 0, 1, 0, 0, 0, 0
9140000000000003, 45, 3, 0, 0, 1, 0, 0, 0, 0
9140000000000003, 45, 3, 0, 0, 1, 0, 0, 0, 0
5140000000000007, 45, 7, 0, 1, 0, 1, 23375, 19335, 4040
9140000000000003, 45, 3, 0, 0, 1, 0, 0, 0, 0
9140000000000003, 45, 3, 0, 0, 1, 0, 0, 0, 0
5140000000000007, 45, 7, 0, 1, 0, 1, 23495, 19435, 4060
9140000000000003, 45, 3, 0, 0, 1, 0, 0, 0, 0
9140000000000003, 45, 3, 0, 0, 1, 0, 0, 0, 0
9140000000000003, 45, 3, 0, 0, 1, 0, 0, 0, 0
5140000000000007, 45, 7, 0, 1, 0, 1, 23615, 19535, 4080
9140000000000003, 45, 3, 0, 0, 1, 0, 0, 0, 0
9140000000000003, 45, 3, 0, 0, 1, 0, 0, 0, 0
5140000000000007, 45, 7, 0, 1, 0, 1, 23735, 19635, 4100
9140000000000005, 45, 5, 0, 0, 1, 0, 0, 0, 0
9140000000000005, 45, 5, 0, 0, 1, 0, 0, 0, 0
5140000000000007, 45, 7, 0, 1, 0, 1, 23855, 19735, 4120
9140000000000003, 45, 3, 0, 0, 1, 0, 0, 0, 0
9140000000000003, 45, 3, 0, 0, 1, 0, 0, 0, 0
9140000000000003, 45, 3, 0, 0, 1, 0, 0, 0, 0
5140000000000007, 45, 7, 0, 1, 0, 1, 23975, 19835, 4140
9140000000000003, 45, 3, 0, 0, 1, 0, 0, 0, 0
9140000000000003, 45, 3, 0, 0, 1, 0, 0, 0, 0
5140000000000007, 45, 7, 0, 1, 0, 1, 24095, 19935, 4160
9140000000000003, 45, 3, 0, 0, 1, 0, 0, 0, 0
9140000000000003, 45, 3, 0, 0, 1, 0, 0, 0, 0
9140000000000003, 45, 3, 0, 0, 1, 0, 0, 0, 0
5140000000000007, 45, 7, 0, 1, 0, 1, 24215, 20035, 4180
9140000000000003, 45, 3, 0, 0, 1, 0, 0, 0, 0
9140000000000003, 45, 3, 0, 0, 1, 0, 0, 0, 0
5140000000000007, 45, 7, 0, 1, 0, 1, 24335, 20135, 4200
9140000000000005, 45, 5, 0, 0, 1, 0, 0, 0, 0
9140000000000005, 45, 5, 0, 0, 1, 0, 0, 0, 0
5140000000000007, 45, 7, 0, 1, 0, 1, 24455, 20235, 4220
9140000000000003, 45, 3, 0, 0, 1, 0, 0, 0, 0
9140000000000003, 45, 3, 0, 0, 1, 0, 0, 0, 0
9140000000000003, 45, 3, 0, 0, 1, 0, 0, 0, 0
5140000000000007, 45, 7, 0, 1, 0, 1, 24575, 20335, 4240
9140000000000003, 45, 3, 0, 0, 1, 0, 0, 0, 0
9140000000000003, 45, 3, 0, 0, 1, 0, 0, 0, 0
5140000000000007, 45, 7, 0, 1, 0, 1, 24695, 20435, 4260
9140000000000003, 45, 3, 0, 0, 1, 0, 0, 0, 0
9140000000000003, 45, 3, 0, 0, 1, 0, 0, 0, 0
9140000000000003, 45, 3, 0, 0, 1, 0, 0, 0, 0
5140000000000007, 45, 7, 0, 1, 0, 1, 24815, 20535, 4280
9140000000000003, 45, 3, 0, 0, 1, 0, 0, 0, 0
9140000000000003, 45, 3, 0, 0, 1, 0, 0, 0, 0
5140000000000007, 45, 7, 0, 1, 0, 1, 24935, 20635, 4300
9140000000000005, 45, 5, 0, 0, 1, 0, 0, 0, 0
9140000000000005, 45, 5, 0, 0, 1, 0, 0, 0, 0
5140000000000007, 45, 7, 0, 1, 0, 1, 25055, 20735, 4320
9140000000000003, 45, 3, 0, 0, 1, 0, 0, 0, 0
9140000000000003, 45, 3, 0, 0, 1, 0, 0, 0, 0
9140000000000003, 45, 3, 0, 0, 1, 0, 0, 0, 0
5140000000000007, 45, 7, 0, 1, 0, 1, 25175, 20835, 4340
9140000000000003, 45, 3, 0, 0, 1, 0, 0, 0, 0
9140000000000003, 45, 3, 0, 0, 1, 0, 0, 0, 0
5140000000000007, 45, 7, 0, 1, 0, 1, 25295, 20935, 4360
9140000000000003, 45, 3, 0, 0, 1, 0, 0, 0, 0
9140000000000003, 45, 3, 0, 0, 1, 0, 0, 0, 0
9140000000000003, 45, 3, 0, 0, 1, 0, 0, 0, 0
5140000000000007, 45, 7, 0, 1, 0, 1, 25415, 21035, 4380
9140000000000003, 45, 3, 0, 0, 1, 0, 0, 0, 0
9140000000000003, 45, 3, 0, 0, 1, 0, 0, 0, 0
5140000000000007, 45, 7, 0, 1, 0, 1, 25535, 21135, 4400
9140000000000005, 45, 5, 0, 0, 1, 0, 0, 0, 0
9140000000000005, 45, 5, 0, 0, 1, 0, 0, 0, 0
5140000000000007, 45, 7, 0, 1, 0, 1, 25655, 21235, 4420
9140000000000003, 45, 3, 0, 0, 1, 0, 0, 0, 0
9140000000000003, 45, 3, 0, 0, 1, 0, 0, 0, 0
9140000000000003, 45, 3, 0, 0, 1, 0, 0, 0, 0
5140000000000007, 45, 7, 0, 1, 0, 1, 25775, 21335, 4440
9140000000000003, 45, 3, 0, 0, 1, 0, 0, 0, 0
9140000000000003, 45, 3, 0, 0, 1, 0, 0, 0, 0
5140000000000007, 45, 7, 0, 1, 0, 1, 25895, 21435, 4460
9140000000000003, 45, 3, 0, 0, 1, 0, 0, 0, 0
9140000000000003, 45, 3, 0, 0, 1, 0, 0, 0, 0
9140000000000003, 45, 3, 0, 0, 1, 0, 0, 0, 0
5140000000000007, 45, 7, 0, 1, 0, 1, 26015, 21535, 4480
9140000000000003, 45, 3, 0, 0, 1, 0, 0, 0, 0
9140000000000003, 45, 3, 0, 0, 1, 0, 0, 0, 0
5140000000000007, 45, 7, 0, 1, 0, 1, 26135, 21635, 4500
9140000000000005, 45, 5, 0, 0, 1, 0, 0, 0, 0
9140000000000005, 45, 5, 0, 0, 1, 0, 0, 0, 0
5140000000000007, 45, 7, 0, 1, 0, 1, 26255, 21735, 4520
9140000000000003, 45, 3, 0, 0, 1, 0, 0, 0, 0
9140000000000003, 45, 3, 0, 0, 1, 0, 0, 0, 0
9140000000000003, 45, 3, 0, 0, 1, 0, 0, 0, 0
5140000000000007, 45, 7, 0, 1, 0, 1, 26375, 21835, 4540
9140000000000003, 45, 3, 0, 0, 1, 0, 0, 0, 0
9140000000000003, 45, 3, 0, 0, 1, 0, 0, 0, 0
5140000000000007, 45, 7, 0, 1, 0, 1, 26495, 21935, 4560
9140000000000003, 45, 3, 0, 0, 1, 0, 0, 0, 0
9140000000000003, 45, 3, 0, 0, 1, 0, 0, 0, 0
9140000000000003, 45, 3, 0, 0, 1, 0, 0, 0, 0
5140000000000007, 45, 7, 0, 1, 0, 1, 26615, 22035, 4580
9140000000000003, 45, 3, 0, 0, 1, 0, 0, 0, 0
9140000000000003, 45, 3, 0, 0, 1, 0, 0, 0, 0
5140000000000007, 45, 7, 0, 1, 0, 1, 26735, 22135, 4600
9140000000000005, 45, 5, 0, 0, 1, 0, 0, 0, 0
9140000000000005, 45, 5, 0, 0, 1, 0, 0, 0, 0
5140000000000007, 45, 7, 0, 1, 0, 1, 26855, 22235, 4620
9140000000000003, 45, 3, 0, 0, 1, 0, 0, 0, 0
9140000000000003, 45, 3, 0, 0, 1, 0, 0, 0, 0
9140000000000003, 45, 3, 0, 0, 1, 0, 0, 0, 0
5140000000000007, 45, 7, 0, 1, 0, 1, 26975, 22335, 4640
9140000000000003, 45, 3, 0, 0, 1, 0, 0, 0, 0
9140000000000003, 45, 3, 0, 0, 1, 0, 0, 0, 0
5140000000000007, 45, 7, 0, 1, 0, 1, 27095, 22435, 4660
9140000000000003, 45, 3, 0, 0, 1, 0, 0, 0, 0
9140000000000003, 45, 3, 0, 0, 1, 0, 0, 0, 0
9140000000000003, 45, 3, 0, 0, 1, 0, 0, 0, 0
5140000000000007, 45, 7, 0, 1, 0, 1, 27215, 22535, 4680
9140000000000003, 45, 3, 0, 0, 1, 0, 0, 0, 0
9140000000000003, 45, 3, 0, 0, 1, 0, 0, 0, 0
5140000000000007, 45, 7, 0, 1, 0, 1, 27335, 22635, 4700
9140000000000005, 45, 5, 0, 0, 1, 0, 0, 0, 0
9140000000000005, 45, 5, 0, 0, 1, 0, 0, 0, 0
5140000000000007, 45, 7, 0, 1, 0, 1, 27455, 22735, 4720
9140000000000003, 45, 3, 0, 0, 1, 0, 0, 0, 0
9140000000000003, 45, 3, 0, 0, 1, 0, 0, 0, 0
9140000000000003, 45, 3, 0, 0, 1, 0, 0, 0, 0
5140000000000007, 45, 7, 0, 1, 0, 1, 27575, 22835, 4740
9140000000000003, 45, 3, 0, 0, 1, 0, 0, 0, 0
9140000000000003, 45, 3, 0, 0, 1, 0, 0, 0, 0
5140000000000007, 45, 7, 0, 1, 0, 1, 27695, 22935, 4760
9140000000000003, 45, 3, 0, 0, 1, 0, 0, 0, 0
9140000000000003, 45, 3, 0, 0, 1, 0, 0, 0, 0
9140000000000003, 45, 3, 0, 0, 1, 0, 0, 0, 0
5140000000000007, 45, 7, 0, 1, 0, 1, 27815, 23035, 4780
9140000000000003, 45, 3, 0, 0, 1, 0, 0, 0, 0
9140000000000003, 45, 3, 0, 0, 1, 0, 0, 0, 0
5140000000000007, 45, 7, 0, 1, 0, 1, 27935, 23135, 4800
9140000000000005, 45, 5, 0, 0, 1, 0, 0, 0, 0
9140000000000005, 45, 5, 0, 0, 1, 0, 0, 0, 0
5140000000000007, 45, 7, 0, 1, 0, 1, 28055, 23235, 4820
9140000000000003, 45, 3, 0, 0, 1, 0, 0, 0, 0
9140000000000003, 45, 3, 0, 0, 1, 0, 0, 0, 0
9140000000000003, 45, 3, 0, 0, 1, 0, 0, 0, 0
5140000000000007, 45, 7, 0, 1, 0, 1, 28175, 23335, 4840
9140000000000003, 45, 3, 0, 0, 1, 0, 0, 0, 0
9140000000000003, 45, 3, 0, 0, 1, 0, 0, 0, 0
5140000000000007, 45, 7, 0, 1, 0, 1, 28295, 23435, 4860
9140000000000003, 45, 3, 0, 0, 1, 0, 0, 0, 0
9140000000000003, 45, 3, 0, 0, 1, 0, 0, 0, 0
9140000000000003, 45, 3, 0, 0, 1, 0, 0, 0, 0
5140000000000007, 45, 7, 0, 1, 0, 1, 28415, 23535, 4880
9140000000000003, 45, 3, 0, 0, 1, 0, 0, 0, 0
9140000000000003, 45, 3, 0, 0, 1, 0, 0, 0, 0
5140000000000007, 45, 7, 0, 1, 0, 1, 28535, 23635, 4900
9140000000000005, 45, 5, 0, 0, 1, 0, 0, 0, 0
9140000000000005, 45, 5, 0, 0, 1, 0, 0, 0, 0
5140000000000007, 45, 7, 0, 1, 0, 1, 28655, 23735, 4920
9140000000000003, 45, 3, 0, 0, 1, 0, 0, 0, 0
9140000000000003, 45, 3, 0, 0, 1, 0, 0, 0, 0
9140000000000003, 45, 3, 0, 0, 1, 0, 0, 0, 0
5140000000000007, 45, 7, 0, 1, 0, 1, 28775, 23835, 4940
9140000000000003, 45, 3, 0, 0, 1, 0, 0, 0, 0
9140000000000003, 45, 3, 0, 0, 1, 0, 0, 0, 0
5140000000000007, 45, 7, 0, 1, 0, 1, 28895, 23935, 4960
9140000000000003, 45, 3, 0, 0, 1, 0, 0, 0, 0
9140000000000003, 45, 3, 0, 0, 1, 0, 0, 0, 0
9140000000000003, 45, 3, 0, 0, 1, 0, 0, 0, 0
5140000000000007, 45, 7, 0, 1, 0, 1, 29015, 24035, 4980
9140000000000003, 45, 3, 0, 0, 1, 0, 0, 0, 0
9140000000000003, 45, 3, 0, 0, 1, 0, 0, 0, 0
5140000000000007, 45, 7, 0, 1, 0, 1, 29135, 24135, 5000
9140000000000005, 45, 5, 0, 0, 1, 0, 0, 0, 0
9140000000000005, 45, 5, 0, 0, 1, 0, 0, 0, 0
5140000000000007, 45, 7, 0, 1, 0, 1, 29255, 24235, 5020
9140000000000003, 45, 3, 0, 0, 1, 0, 0, 0, 0
9140000000000003, 45, 3, 0, 0, 1, 0, 0, 0, 0
9140000000000003, 45, 3, 0, 0, 1, 0, 0, 0, 0
5140000000000007, 45, 7, 0, 1, 0, 1, 29375, 24335, 5040
9140000000000003, 45, 3, 0, 0, 1, 0, 0, 0, 0
9140000000000003, 45, 3, 0, 0, 1, 0, 0, 0, 0
5140000000000007, 45, 7, 0, 1, 0, 1, 29495, 24435, 5060
9140000000000003, 45, 3, 0, 0, 1, 0, 0, 0, 0
9140000000000003, 45, 3, 0, 0, 1, 0, 0, 0, 0
9140000000000003, 45, 3, 0, 0, 1, 0, 0, 0, 0
5140000000000007, 45, 7, 0, 1, 0, 1, 29615, 24535, 5080
9140000000000003, 45, 3, 0, 0, 1, 0, 0, 0, 0
9140000000000003, 45, 3, 0, 0, 1, 0, 0, 0, 0
5140000000000007, 45, 7, 0, 1, 0, 1, 29735, 24635, 5100
9140000000000005, 45, 5, 0, 0, 1, 0, 0, 0, 0
9140000000000005, 45, 5, 0, 0, 1, 0, 0, 0, 0
5140000000000007, 45, 7, 0, 1, 0, 1, 29855, 24735, 5120
9140000000000003, 45, 3, 0, 0, 1, 0, 0, 0, 0
9140000000000003, 45, 3, 0, 0, 1, 0, 0, 0, 0
9140000000000003, 45, 3, 0, 0, 1, 0, 0, 0, 0
5140000000000007, 45, 7, 0, 1, 0, 1, 29975, 24835, 5140
9140000000000003, 45, 3, 0, 0, 1, 0, 0, 0, 0
9140000000000003, 45, 3, 0, 0, 1, 0, 0, 0, 0
5140000000000007, 45, 7, 0, 1, 0, 1, 30095, 24935, 5160
9140000000000003, 45, 3, 0, 0, 1, 0, 0, 0, 0
9140000000000003, 45, 3, 0, 0, 1, 0, 0, 0, 0
9140000000000003, 45, 3, 0, 0, 1, 0, 0, 0, 0
5140000000000007, 45, 7, 0, 1, 0, 1, 30215, 25035, 5180
9140000000000003, 45, 3, 0, 0, 1, 0, 0, 0, 0
9140000000000003, 45, 3, 0, 0, 1, 0, 0, 0, 0
5140000000000007, 45, 7, 0, 1, 0, 1, 30335, 25135, 5200
9140000000000005, 45, 5, 0, 0, 1, 0, 0, 0, 0
9140000000000005, 45, 5, 0, 0, 1, 0, 0, 0, 0
5140000000000007, 45, 7, 0, 1, 0, 1, 30455, 25235, 5220
9140000000000003, 45, 3, 0, 0, 1, 0, 0, 0, 0
9140000000000003, 45, 3, 0, 0, 1, 0, 0, 0, 0
9140000000000003, 45, 3, 0, 0, 1, 0, 0, 0, 0
5140000000000007, 45, 7, 0, 1, 0, 1, 30575, 25335, 5240
9140000000000003, 45, 3, 0, 0, 1, 0, 0, 0, 0
9140000000000003, 45, 3, 0, 0, 1, 0, 0, 0, 0
5140000000000007, 45, 7, 0, 1, 0, 1, 30695, 25435, 5260
9140000000000003, 45, 3, 0, 0, 1, 0, 0, 0, 0
9140000000000003, 45, 3, 0, 0, 1, 0, 0, 0, 0
9140000000000003, 45, 3, 0, 0, 1, 0, 0, 0, 0
5140000000000007, 45, 7, 0, 1, 0, 1, 30815, 25535, 5280
9140000000000003, 45, 3, 0, 0, 1, 0, 0, 0, 0
9140000000000003, 45, 3, 0, 0, 1, 0, 0, 0, 0
5140000000000007, 45, 7, 0, 1, 0, 1, 30935, 25635, 5300
9140000000000005, 45, 5, 0, 0, 1, 0, 0, 0, 0
9140000000000005, 45, 5, 0, 0, 1, 0, 0, 0, 0
5140000000000007, 45, 7, 0, 1, 0, 1, 31055, 25735, 5320
9140000000000003, 45, 3, 0, 0, 1, 0, 0, 0, 0
9140000000000003, 45, 3, 0, 0, 1, 0, 0, 0, 0
9140000000000003, 45, 3, 0, 0, 1, 0, 0, 0, 0
5140000000000007, 45, 7, 0, 1, 0, 1, 31175, 25835, 5340
9140000000000003, 45, 3, 0, 0, 1, 0, 0, 0, 0
9140000000000003, 45, 3, 0, 0, 1, 0, 0, 0, 0
5140000000000007, 45, 7, 0, 1, 0, 1, 31295, 25935, 5360
9140000000000003, 45, 3, 0, 0, 1, 0, 0, 0, 0
9140000000000003, 45, 3, 0, 0, 1, 0, 0, 0, 0
9140000000000003, 45, 3, 0, 0, 1, 0, 0, 0, 0
5140000000000007, 45, 7, 0, 1, 0, 1, 31415, 26035, 5380
9140000000000003, 45, 3, 0, 0, 1, 0, 0, 0, 0
9140000000000003, 45, 3, 0, 0, 1, 0, 0, 0, 0
5140000000000007, 45, 7, 0, 1, 0, 1, 31535, 26135, 5400
9140000000000005, 45, 5, 0, 0, 1, 0, 0, 0, 0
9140000000000005, 45, 5, 0, 0, 1, 0, 0, 0, 0
5140000000000007, 45, 7, 0, 1, 0, 1, 31655, 26235, 5420
9140000000000003, 45, 3, 0, 0, 1, 0, 0, 0, 0
9140000000000003, 45, 3, 0, 0, 1, 0, 0, 0, 0
9140000000000003, 45, 3, 0, 0, 1, 0, 0, 0, 0
5140000000000007, 45, 7, 0, 1, 0, 1, 31775, 26335, 5440
9140000000000003, 45, 3, 0, 0, 1, 0, 0, 0, 0
9140000000000003, 45, 3, 0, 0, 1, 0, 0, 0, 0
5140000000000007, 45, 7, 0, 1, 0, 1, 31895, 26435, 5460
9140000000000003, 45, 3, 0, 0, 1, 0, 0, 0, 0
9140000000000003, 45, 3, 0, 0, 1, 0, 0, 0, 0
9140000000000003, 45, 3, 0, 0, 1, 0, 0, 0, 0
5140000000000007, 45, 7, 0, 1, 0, 1, 32015, 26535, 5480
9140000000000003, 45, 3, 0, 0, 1, 0, 0, 0, 0
9140000000000003, 45, 3, 0, 0, 1, 0, 0, 0, 0
5140000000000007, 45, 7, 0, 1, 0, 1, 32135, 26635, 5500
9140000000000005, 45, 5, 0, 0, 1, 0, 0, 0, 0
9140000000000005, 45, 5, 0, 0, 1, 0, 0, 0, 0
5140000000000007, 45, 7, 0, 1, 0, 1, 32255, 26735, 5520
9140000000000003, 45, 3, 0, 0, 1, 0, 0, 0, 0
9140000000000003, 45, 3, 0, 0, 1, 0, 0, 0, 0
9140000000000003, 45, 3, 0, 0, 1, 0, 0, 0, 0
5140000000000007, 45, 7, 0, 1, 0, 1, 32375, 26835, 5540
9140000000000003, 45, 3, 0, 0, 1, 0, 0, 0, 0
9140000000000003, 45, 3, 0, 0, 1, 0, 0, 0, 0
5140000000000007, 45, 7, 0, 1, 0, 1, 32495, 26935, 5560
9140000000000003, 45, 3, 0, 0, 1, 0, 0, 0, 0
9140000000000003, 45, 3, 0, 0, 1, 0, 0, 0, 0
9140000000000003, 45, 3, 0, 0, 1, 0, 0, 0, 0
5140000000000007, 45, 7, 0, 1, 0, 1, 32615, 27035, 5580
9140000000000003, 45, 3, 0, 0, 1, 0, 0, 0, 0
9140000000000003, 45, 3, 0, 0, 1, 0, 0, 0, 0
5140000000000007, 45, 7, 0, 1, 0, 1, 32735, 27135, 5600
9140000000000005, 45, 5, 0, 0, 1, 0, 0, 0, 0
9140000000000005, 45, 5, 0, 0, 1, 0, 0, 0, 0
5140000000000007, 45, 7, 0, 1, 0, 1, 32855, 27235, 5620
9140000000000003, 45, 3, 0, 0, 1, 0, 0, 0, 0
9140000000000003, 45, 3, 0, 0, 1, 0, 0, 0, 0
9140000000000003, 45, 3, 0, 0, 1, 0, 0, 0, 0
5140000000000007, 45, 7, 0, 1, 0, 1, 32975, 27335, 5640
9140000000000003, 45, 3, 0, 0, 1, 0, 0, 0, 0
9140000000000003, 45, 3, 0, 0, 1, 0, 0, 0, 0
5140000000000007, 45, 7, 0, 1, 0, 1, 33095, 27435, 5660
9140000000000003, 45, 3, 0, 0, 1, 0, 0, 0, 0
9140000000000003, 45, 3, 0, 0, 1, 0, 0, 0, 0
9140000000000003, 45, 3, 0, 0, 1, 0, 0, 0, 0
5140000000000007, 45, 7, 0, 1, 0, 1, 33215, 27535, 5680
9140000000000003, 45, 3, 0, 0, 1, 0, 0, 0, 0
9140000000000003, 45, 3, 0, 0, 1, 0, 0, 0, 0
5140000000000007, 45, 7, 0, 1, 0, 1, 33335, 27635, 5700
9140000000000005, 45, 5, 0, 0, 1, 0, 0, 0, 0
9140000000000005, 45, 5, 0, 0, 1, 0, 0, 0, 0
5140000000000007, 45, 7, 0, 1, 0, 1, 33455, 27735, 5720
9140000000000003, 45, 3, 0, 0, 1, 0, 0, 0, 0
9140000000000003, 45, 3, 0, 0, 1, 0, 0, 0, 0
9140000000000003, 45, 3, 0, 0, 1, 0, 0, 0, 0
5140000000000007, 45, 7, 0, 1, 0, 1, 33575, 27835, 5740
9140000000000003, 45, 3, 0, 0, 1, 0, 0, 0, 0
9140000000000003, 45, 3, 0, 0, 1, 0, 0, 0, 0
5140000000000007, 45, 7, 0, 1, 0, 1, 33695, 27935, 5760
9140000000000003, 45, 3, 0, 0, 1, 0, 0, 0, 0
9140000000000003, 45, 3, 0, 0, 1, 0, 0, 0, 0
9140000000000003, 45, 3, 0, 0, 1, 0, 0, 0, 0
5140000000000007, 45, 7, 0, 1, 0, 1, 33815, 28035, 5780
9140000000000003, 45, 3, 0, 0, 1, 0, 0, 0, 0
9140000000000003, 45, 3, 0, 0, 1, 0, 0, 0, 0
5140000000000007, 45, 7, 0, 1, 0, 1, 33935, 28135, 5800
9140000000000005, 45, 5, 0, 0, 1, 0, 0, 0, 0
9140000000000005, 45, 5, 0, 0, 1, 0, 0, 0, 0
5140000000000007, 45, 7, 0, 1, 0, 1, 34055, 28235, 5820
9140000000000003, 45, 3, 0, 0, 1, 0, 0, 0, 0
9140000000000003, 45, 3, 0, 0, 1, 0, 0, 0, 0
9140000000000003, 45, 3, 0, 0, 1, 0, 0, 0, 0
5140000000000007, 45, 7, 0, 1, 0, 1, 34175, 28335, 5840
9140000000000003, 45, 3, 0, 0, 1, 0, 0, 0, 0
9140000000000003, 45, 3, 0, 0, 1, 0, 0, 0, 0
5140000000000007, 45, 7, 0, 1, 0, 1, 34295, 28435, 5860
9140000000000003, 45, 3, 0, 0, 1, 0, 0, 0, 0
9140000000000003, 45, 3, 0, 0, 1, 0, 0, 0, 0
9140000000000003, 45, 3, 0, 0, 1, 0, 0, 0, 0
5140000000000007, 45, 7, 0, 1, 0, 1, 34415, 28535, 5880
9140000000000003, 45, 3, 0, 0, 1, 0, 0, 0, 0
9140000000000003, 45, 3, 0, 0, 1, 0, 0, 0, 0
5140000000000007, 45, 7, 0, 1, 0, 1, 34535, 28635, 5900
9140000000000005, 45, 5, 0, 0, 1, 0, 0, 0, 0
9140000000000005, 45, 5, 0, 0, 1, 0, 0, 0, 0
5140000000000007, 45, 7, 0, 1, 0, 1, 34655, 28735, 5920
9140000000000003, 45, 3, 0, 0, 1, 0, 0, 0, 0
9140000000000003, 45, 3, 0, 0, 1, 0, 0, 0, 0
9140000000000003, 45, 3, 0, 0, 1, 0, 0, 0, 0
5140000000000007, 45, 7, 0, 1, 0, 1, 34775, 28835, 5940
9140000000000003, 45, 3, 0, 0, 1, 0, 0, 0, 0
9140000000000003, 45, 3, 0, 0, 1, 0, 0, 0, 0
5140000000000007, 45, 7, 0, 1, 0, 1, 34895, 28935, 5960
9140000000000003, 45, 3, 0, 0, 1, 0, 0, 0, 0
9140000000000003, 45, 3, 0, 0, 1, 0, 0, 0, 0
9140000000000003, 45, 3, 0, 0, 1, 0, 0, 0, 0
5140000000000007, 45, 7, 0, 1, 0, 1, 35015, 29035, 5980
9140000000000003, 45, 3, 0, 0, 1, 0, 0, 0, 0
9140000000000003, 45, 3, 0, 0, 1, 0, 0, 0, 0
5140000000000007, 45, 7, 0, 1, 0, 1, 35135, 29135, 6000
9140000000000005, 45, 5, 0, 0, 1, 0, 0, 0, 0
9140000000000005, 45, 5, 0, 0, 1, 0, 0, 0, 0
5140000000000007, 45, 7, 0, 1, 0, 1, 35255, 29235, 6020
9140000000000003, 45, 3, 0, 0, 1, 0, 0, 0, 0
9140000000000003, 45, 3, 0, 0, 1, 0, 0, 0, 0
9140000000000003, 45, 3, 0, 0, 1, 0, 0, 0, 0
5140000000000007, 45, 7, 0, 1, 0, 1, 35375, 29335, 6040
9140000000000003, 45, 3, 0, 0, 1, 0, 0, 0, 0
9140000000000003, 45, 3, 0, 0, 1, 0, 0, 0, 0
5140000000000007, 45, 7, 0, 1, 0, 1, 35495, 29435, 6060
9140000000000003, 45, 3, 0, 0, 1, 0, 0, 0, 0
9140000000000003, 45, 3, 0, 0, 1, 0, 0, 0, 0
9140000000000003, 45, 3, 0, 0, 1, 0, 0, 0, 0
5140000000000007, 45, 7, 0, 1, 0, 1, 35615, 29535, 6080
9140000000000003, 45, 3, 0, 0, 1, 0, 0, 0, 0
9140000000000003, 45, 3, 0, 0, 1, 0, 0, 0, 0
5140000000000007, 45, 7, 0, 1, 0, 1, 35735, 29635, 6100
9140000000000005, 45, 5, 0, 0, 1, 0, 0, 0, 0
9140000000000005, 45, 5, 0, 0, 1, 0, 0, 0, 0
5140000000000007, 45, 7, 0, 1, 0, 1, 35855, 29735, 6120
9140000000000003, 45, 3, 0, 0, 1, 0, 0, 0, 0
9140000000000003, 45, 3, 0, 0, 1, 0, 0, 0, 0
9140000000000003, 45, 3, 0, 0, 1, 0, 0, 0, 0
5140000000000007, 45, 7, 0, 1, 0, 1, 35975, 29835, 6140
9140000000000003, 45, 3, 0, 0, 1, 0, 0, 0, 0
9140000000000003, 45, 3, 0, 0, 1, 0, 0, 0, 0
5140000000000007, 45, 7, 0, 1, 0, 1, 36095, 29935, 6160
9140000000000003, 45, 3, 0, 0, 1, 0, 0, 0, 0
9140000000000003, 45, 3, 0, 0, 1, 0, 0, 0, 0
9140000000000003, 45, 3, 0, 0, 1, 0, 0, 0, 0
5140000000000007, 45, 7, 0, 1, 0, 1, 36215, 30035, 6180
9140000000000003, 45, 3, 0, 0, 1, 0, 0, 0, 0
9140000000000003, 45, 3, 0, 0, 1, 0, 0, 0, 0
5140000000000007, 45, 7, 0, 1, 0, 1, 36335, 30135, 6200
9140000000000005, 45, 5, 0, 0, 1, 0, 0, 0, 0
9140000000000005, 45, 5, 0, 0, 1, 0, 0, 0, 0
5140000000000007, 45, 7, 0, 1, 0, 1, 36455, 30235, 6220
9140000000000003, 45, 3, 0, 0, 1, 0, 0, 0, 0
9140000000000003, 45, 3, 0, 0, 1, 0, 0, 0, 0
9140000000000003, 45, 3, 0, 0, 1, 0, 0, 0, 0
5140000000000007, 45, 7, 0, 1, 0, 1, 36575, 30335, 6240
9140000000000003, 45, 3, 0, 0, 1, 0, 0, 0, 0
9140000000000003, 45, 3, 0, 0, 1, 0, 0, 0, 0
5140000000000007, 45, 7, 0, 1, 0, 1, 36695, 30435, 6260
9140000000000003, 45, 3, 0, 0, 1, 0, 0, 0, 0
9140000000000003, 45, 3, 0, 0, 1, 0, 0, 0, 0
9140000000000003, 45, 3, 0, 0, 1, 0, 0, 0, 0
5140000000000007, 45, 7, 0, 1, 0, 1, 36815, 30535, 6280
9140000000000003, 45, 3, 0, 0, 1, 0, 0, 0, 0
9140000000000003, 45, 3, 0, 0, 1, 0, 0, 0, 0
5140000000000007, 45, 7, 0, 1, 0, 1, 36935, 30635, 6300
9140000000000005, 45, 5, 0, 0, 1, 0, 0, 0, 0
9140000000000005, 45, 5, 0, 0, 1, 0, 0, 0, 0
5140000000000007, 45, 7, 0, 1, 0, 1, 37055, 30735, 6320
9140000000000003, 45, 3, 0, 0, 1, 0, 0, 0, 0
9140000000000003, 45, 3, 0, 0, 1, 0, 0, 0, 0
9140000000000003, 45, 3, 0, 0, 1, 0, 0, 0, 0
5140000000000007, 45, 7, 0, 1, 0, 1, 37175, 30835, 6340
9140000000000003, 45, 3, 0, 0, 1, 0, 0, 0, 0
9140000000000003, 45, 3, 0, 0, 1, 0, 0, 0, 0
5140000000000007, 45, 7, 0, 1, 0, 1, 37295, 30935, 6360
9140000000000003, 45, 3, 0, 0, 1, 0, 0, 0, 0
9140000000000003, 45, 3, 0, 0, 1, 0, 0, 0, 0
9140000000000003, 45, 3, 0, 0, 1, 0, 0, 0, 0
5140000000000007, 45, 7, 0, 1, 0, 1, 37415, 31035, 6380
9140000000000003, 45, 3, 0, 0, 1, 0, 0, 0, 0
9140000000000003, 45, 3, 0, 0, 1, 0, 0, 0, 0
5140000000000007, 45, 7, 0, 1, 0, 1, 37535, 31135, 6400
9140000000000005, 45, 5, 0, 0, 1, 0, 0, 0, 0
9140000000000005, 45, 5, 0, 0, 1, 0, 0, 0, 0
5140000000000007, 45, 7, 0, 1, 0, 1, 37655, 31235, 6420
9140000000000003, 45, 3, 0, 0, 1, 0, 0, 0, 0
9140000000000003, 45, 3, 0, 0, 1, 0, 0, 0, 0
9140000000000003, 45, 3, 0, 0, 1, 0, 0, 0, 0
5140000000000007, 45, 7, 0, 1, 0, 1, 37775, 31335, 6440
9140000000000003, 45, 3, 0, 0, 1, 0, 0, 0, 0
9140000000000003, 45, 3, 0, 0, 1, 0, 0, 0, 0
5140000000000007, 45, 7, 0, 1, 0, 1, 37895, 31435, 6460
9140000000000003, 45, 3, 0, 0, 1, 0, 0, 0, 0
9140000000000003, 45, 3, 0, 0, 1, 0, 0, 0, 0
9140000000000003, 45, 3, 0, 0, 1, 0, 0, 0, 0
5140000000000007, 45, 7, 0, 1, 0, 1, 38015, 31535, 6480
9140000000000003, 45, 3, 0, 0, 1, 0, 0, 0, 0
9140000000000003, 45, 3, 0, 0, 1, 0, 0, 0, 0
5140000000000007, 45, 7, 0, 1, 0, 1, 38135, 31635, 6500
9140000000000005, 45, 5, 0, 0, 1, 0, 0, 0, 0
9140000000000005, 45, 5, 0, 0, 1, 0, 0, 0, 0
5140000000000007, 45, 7, 0, 1, 0, 1, 38255, 31735, 6520
9140000000000003, 45, 3, 0, 0, 1, 0, 0, 0, 0
9140000000000003, 45, 3, 0, 0, 1, 0, 0, 0, 0
9140000000000003, 45, 3, 0, 0, 1, 0, 0, 0, 0
5140000000000007, 45, 7, 0, 1, 0, 1, 38375, 31835, 6540
9140000000000003, 45, 3, 0, 0, 1, 0, 0, 0, 0
9140000000000003, 45, 3, 0, 0, 1, 0, 0, 0, 0
5140000000000007, 45, 7, 0, 1, 0, 1, 38495, 31935, 6560
9140000000000003, 45, 3, 0, 0, 1, 0, 0, 0, 0
9140000000000003, 45, 3, 0, 0, 1, 0, 0, 0, 0
9140000000000003, 45, 3, 0, 0, 1, 0, 0, 0, 0
5140000000000007, 45, 7, 0, 1, 0, 1, 38615, 32035, 6580
9140000000000003, 45, 3, 0, 0, 1, 0, 0, 0, 0
9140000000000003, 45, 3, 0, 0, 1, 0, 0, 0, 0
5140000000000007, 45, 7, 0, 1, 0, 1, 38735, 32135, 6600
9140000000000005, 45, 5, 0, 0, 1, 0, 0, 0, 0
9140000000000005, 45, 5, 0, 0, 1, 0, 0, 0, 0
5140000000000007, 45, 7, 0, 1, 0, 1, 38855, 32235, 6620
9140000000000003, 45, 3, 0, 0, 1, 0, 0, 0, 0
9140000000000003, 45, 3, 0, 0, 1, 0, 0, 0, 0
9140000000000003, 45, 3, 0, 0, 1, 0, 0, 0, 0
5140000000000007, 45, 7, 0, 1, 0, 1, 38975, 32335, 6640
9140000000000003, 45, 3, 0, 0, 1, 0, 0, 0, 0
9140000000000003, 45, 3, 0, 0, 1, 0, 0, 0, 0
5140000000000007, 45, 7, 0, 1, 0, 1, 39095, 32435, 6660
9140000000000003, 45, 3, 0, 0, 1, 0, 0, 0, 0
9140000000000003, 45, 3, 0, 0, 1, 0, 0, 0, 0
9140000000000003, 45, 3, 0, 0, 1, 0, 0, 0, 0
5140000000000007, 45, 7, 0, 1, 0, 1, 39215, 32535, 6680
9140000000000003, 45, 3, 0, 0, 1, 0, 0, 0, 0
9140000000000003, 45, 3, 0, 0, 1, 0, 0, 0, 0
5140000000000007, 45, 7, 0, 1, 0, 1, 39335, 32635, 6700
9140000000000005, 45, 5, 0, 0, 1, 0, 0, 0, 0
9140000000000005, 45, 5, 0, 0, 1, 0, 0, 0, 0
5140000000000007, 45, 7, 0, 1, 0, 1, 39455, 32735, 6720
9140000000000003, 45, 3, 0, 0, 1, 0, 0, 0, 0
9140000000000003, 45, 3, 0, 0, 1, 0, 0, 0, 0
9140000000000003, 45, 3, 0, 0, 1, 0, 0, 0, 0
5140000000000007, 45, 7, 0, 1, 0, 1, 39575, 32835, 6740
9140000000000003, 45, 3, 0, 0, 1, 0, 0, 0, 0
9140000000000003, 45, 3, 0, 0, 1, 0, 0, 0, 0
5140000000000007, 45, 7, 0, 1, 0, 1, 39695, 32935, 6760
9140000000000003, 45, 3, 0, 0, 1, 0, 0, 0, 0
9140000000000003, 45, 3, 0, 0, 1, 0, 0, 0, 0
9140000000000003, 45, 3, 0, 0, 1, 0, 0, 0, 0
5140000000000007, 45, 7, 0, 1, 0, 1, 39815, 33035, 6780
9140000000000003, 45, 3, 0, 0, 1, 0, 0, 0, 0
9140000000000003, 45, 3, 0, 0, 1, 0, 0, 0, 0
5140000000000007, 45, 7, 0, 1, 0, 1, 39935, 33135, 6800
9140000000000005, 45, 5, 0, 0, 1, 0, 0, 0, 0
9140000000000005, 45, 5, 0, 0, 1, 0, 0, 0, 0
5140000000000007, 45, 7, 0, 1, 0, 1, 40055, 33235, 6820
9140000000000003, 45, 3, 0, 0, 1, 0, 0, 0, 0
9140000000000003, 45, 3, 0, 0, 1, 0, 0, 0, 0
9140000000000003, 45, 3, 0, 0, 1, 0, 0, 0, 0
5140000000000007, 45, 7, 0, 1, 0, 1, 40175, 33335, 6840
9140000000000003, 45, 3, 0, 0, 1, 0, 0, 0, 0
9140000000000003, 45, 3, 0, 0, 1, 0, 0, 0, 0
5140000000000007, 45, 7, 0, 1, 0, 1, 40295, 33435, 6860
9140000000000003, 45, 3, 0, 0, 1, 0, 0, 0, 0
9140000000000003, 45, 3, 0, 0, 1, 0, 0, 0, 0
5140000000000007, 45, 7, 0, 1, 0, 1, 40415, 33535, 6880
9140000000000003, 45, 3, 0, 0, 1, 0, 0, 0, 0
9140000000000003, 45, 3, 0, 0, 1, 0, 0, 0, 0
5140000000000007, 45, 7, 0, 1, 0, 1, 40535, 33635, 6900
5140000000000003, 45, 3, 0, 1, 0, 1, 40575, 32415, 8160
5140000000000003, 45, 3, 0, 1, 0, 1, 40675, 32535, 8140
5140000000000003, 45, 3, 0, 1, 0, 1, 40775, 32655, 8120
5140000000000005, 45, 5, 0, 1, 0, 1, 40875, 26635, 14240
5140000000000002, 45, 2, 0, 1, 0, 1, 40975, 135, 40840
5140000000000001, 45, 1, 0, 1, 0, 1, 41075, 215, 40860
5140000000000002, 45, 2, 0, 1, 0, 1, 41175, 395, 40780
5140000000000000, 45, 0, 0, 1, 0, 1, 41275, 155, 41120
5140000000000001, 45, 1, 0, 1, 0, 1, 41375, 335, 41040
5140000000000000, 45, 0, 0, 1, 0, 1, 41475, 275, 41200
5140000000000004, 45, 4, 0, 1, 0, 1, 41575, 115, 41460
5140000000000000, 45, 0, 0, 1, 0, 1, 41675, 395, 41280
